# <text>
BuilderCollate=Sortimisreeglid
BuilderCollateNoAccent=noaccent
BuilderCollateNoCase=nocase
BuilderCollateNoKanaType=nokanatype
BuilderCollateNoSymbols=nosymbols
BuilderCollateNoWidth=nowidth
BuilderCollateWordSort=wordsort
BuilderConstant=Konstandid
BuilderConstantCr=CR
BuilderConstantCrLf=CRLF
BuilderConstantE=E
BuilderConstantFalse=FALSE
BuilderConstantFloat32Max=FLOAT32MAX
BuilderConstantFloat32Min=FLOAT32MIN
BuilderConstantFloat64Max=FLOAT64MAX
BuilderConstantFloat64Min=FLOAT64MIN
BuilderConstantInt8Max=INT8MAX
BuilderConstantInt8Min=INT8MIN
BuilderConstantInt8UMax=UINT8MAX
BuilderConstantInt16Max=INT16MAX
BuilderConstantInt16Min=INT16MIN
BuilderConstantInt16UMax=UINT16MAX
BuilderConstantInt32Max=INT32MAX
BuilderConstantInt32Min=INT32MIN
BuilderConstantInt32UMax=UINT32MAX
BuilderConstantLf=LF
BuilderConstantNull=NULL
BuilderConstantPi=PI
BuilderConstantTrue=TRUE
BuilderConstantWhitespace=WHITESPACE
BuilderFields=Väljad
BuilderFunction=Funktsioonid
BuilderFunctionAbs=Abs(<arv>) : <arv>
BuilderFunctionAcos=Acos(<arv>) : <radiaanmõõt>
BuilderFunctionAcosh=Acosh(<arv>) : <radiaanmõõt>
BuilderFunctionAggregate=Agregaator-funktsioonid
BuilderFunctionAsin=Asin(<arv>) : <radiaanmõõt>
BuilderFunctionAsinh=Asinh(<arv>) : <radiaanmõõt>
BuilderFunctionAtan=Atan(<arv>) : <radiaanmõõt>
BuilderFunctionAtan2=Atan2(<y>, <x>) : <radiaanmõõt>
BuilderFunctionAtanh=Atanh(<arv>) : <radiaanmõõt>
BuilderFunctionAvg=Avg(<arv>) : <arv>
BuilderFunctionBinaryStringBase64=BinaryStringBase64(<baidijada>) : <sõne>
BuilderFunctionBinaryStringHex=BinaryStringHex(<baidijada>) : <sõne>
BuilderFunctionBinaryWkbGeom=BinaryWkbGeom(<wkb>) : <ruumikuju>
BuilderFunctionBound=Bound(<arv>, <alates>, <kuni>, <rangeJärjekord?>) : <arv>
BuilderFunctionCbrt=Cbrt(<arv>) : <arv>
BuilderFunctionCeil=Ceil(<arv>) : <arv>
BuilderFunctionCeilDecs=CeilDecs(<arv>, <kümnendkohti>) : <arv>
BuilderFunctionChr=Chr(<arv>) : <sõne>
BuilderFunctionCoalesce=Coalesce(<väärtus>, ...) : <väärtus>
BuilderFunctionCollateCode=CollateCode(<sorteerimisalus>) : <sorteerimiskood>
BuilderFunctionCollateCodeDef=CollateCodeDef(<sorteerimiskood>) : <sorteerimisalus>
BuilderFunctionCompare=Compare(<väärtus>, <väärtus>) : <arv>
BuilderFunctionComponentBounds=ComponentBounds(<komponent>, <sunnitudArvutamine>) : <kastx4>
BuilderFunctionComponentCoordSystem=ComponentCoordSystem(<komponent>) : <projektsioon>
BuilderFunctionComponentFieldBounds=ComponentFieldBounds(<komponent>, <väljanimi>, <sunnitudArvutamine>) : <kastx4>
BuilderFunctionComponentFieldCoordSystem=ComponentFieldCoordSystem(<komponent>, <väljanimi>) : <projektsioon>
BuilderFunctionComponentFieldDrawing=ComponentFieldDrawing(<komponent>, <väljanimi>) : <vektorjoonis>
BuilderFunctionComponentFieldImage=ComponentFieldImage(<komponent>, <väljanimi>) : <raster>
BuilderFunctionComponentName=ComponentName(<komponent>) : <sõne>
BuilderFunctionComponentPath=ComponentPath(<komponent>, <alam>) : <sõne>
BuilderFunctionComponentProperty=ComponentProperty(<komponent>, <atribuut>) : <sõne>
BuilderFunctionComponentType=ComponentType(<komponent>) : <sõne>
BuilderFunctionCoordConvert=CoordConvert(<konverter>, <ruumikuju>) : <ruumikuju>
BuilderFunctionCoordConvertPoint=CoordConvertPoint(<konverter>, <arvx2>) : <arvx2>
BuilderFunctionCoordConvertPoint3=CoordConvertPoint3(<konverter>, <arvx3>) : <arvx3>
BuilderFunctionCoordConvertRect=CoordConvertRect(<konverter>, <kastx4>, <vahesamme>) : <kastx4>
BuilderFunctionCoordConvertTile=CoordConvertTile(<konverter>, <raster>, <kastx4>, <interpolatsioon>) : <tail>
BuilderFunctionCoordConvertTileSet=CoordConvertTileSet(<konverter>, <raster>, <kastx4>, <interpolatsioon>) : <tabel>
BuilderFunctionCoordConvertTileSetDirect=CoordConvertTileSetDirect(<konverter>, <raster>, <kastx4>, <jaotisi>) : <tabel>
BuilderFunctionCoordConvertTileSetDirectPar=CoordConvertTileSetDirectPar(<konverter>, <raster>, <kastx4>, <jaotisi>, <konf>) : <tabel>
BuilderFunctionCoordConvertTileSetPar=CoordConvertTileSetPar(<konverter>, <raster>, <kastx4>, <interpolatsioon>, <konf>) : <tabel>
BuilderFunctionCoordConvertTrace=CoordConvertTrace(<konverter>, <arvx3>) : <tabel>
BuilderFunctionCoordConverterIsIdentity=CoordConverterIsIdentity(<konverter>) : <tõeväärtus>
BuilderFunctionCoordConverterIsScaleShift=CoordConverterIsScaleShift(<konverter>) : <tõeväärtus>
BuilderFunctionCoordConverterIsScaleShiftSwap=CoordConverterIsScaleShiftSwap(<konverter>) : <tõeväärtus>
BuilderFunctionCoordConverterIsXYZ=CoordConverterIsXYZ(<konverter>) : <tõeväärtus>
BuilderFunctionCoordConverterMake=CoordConverterMake(<milleks>, <millest>) : <konverter>
BuilderFunctionCoordConverterMakePath=CoordConverterMakePath(<milleks>, <millest>, <vihje>, <täpne?>) : <konverter>
BuilderFunctionCoordConverterMakeWarpNumeric=CoordConverterMakeWarpNumeric(<ruumikuju-millest-milleks>, <järk>) : <konverter>
BuilderFunctionCoordConverterMakeWarpThinPlateSpline=CoordConverterMakeWarpThinPlateSpline(<ruumikuju-millest-milleks>) : <konverter>
BuilderFunctionCoordConverterMakeWarpTriangulation=CoordConverterMakeWarpTriangulation(<ruumikuju-millest-milleks>) : <konverter>
BuilderFunctionCoordConverterSteps=CoordConverterSteps(<konverter>) : <tabel>
BuilderFunctionCoordDatum=CoordDatum(<manifold>) : <daatum>
BuilderFunctionCoordDatumDefault=CoordDatumDefault() : <daatum>
BuilderFunctionCoordDatumEpsg=CoordDatumEpsg(<epsg>) : <daatum>
BuilderFunctionCoordDatumParameters=CoordDatumParameters() : <tabel>
BuilderFunctionCoordDatums=CoordDatums() : <tabel>
BuilderFunctionCoordMeasureArea=CoordMeasureArea(<mõõt>, <ruumikuju>) : <arv>
BuilderFunctionCoordMeasureBearing=CoordMeasureBearing(<mõõt>, <ruumikuju>) : <arv>
BuilderFunctionCoordMeasureBearingPoint=CoordMeasureBearingPoint(<mõõt>, <arvx2>, <arvx2>) : <arv>
BuilderFunctionCoordMeasureDistancePoint=CoordMeasureDistancePoint(<mõõt>, <arvx2>, <arvx2>) : <arv>
BuilderFunctionCoordMeasureLength=CoordMeasureLength(<mõõt>, <ruumikuju>) : <arv>
BuilderFunctionCoordMeasureRadius=CoordMeasureRadius(<mõõt>, <ruumikuju>) : <arv>
BuilderFunctionCoordMeasureMake=CoordMeasureMake(<projektsioon>, <ühik>, <daatum>) : <mõõt>
BuilderFunctionCoordSystem=CoordSystem(<manifold>) : <projektsioon>
BuilderFunctionCoordSystemBase=CoordSystemBase(<projektsioon>) : <projektsioon>
BuilderFunctionCoordSystemDefault=CoordSystemDefault() : <projektsioon>
BuilderFunctionCoordSystemDefaultLatLon=CoordSystemDefaultLatLon() : <projektsioon>
BuilderFunctionCoordSystemEpsg=CoordSystemEpsg(<epsg>) : <projektsioon>
BuilderFunctionCoordSystemForceXY=CoordSystemForceXY(<projektsioon>) : <projektsioon>
BuilderFunctionCoordSystemMatchEpsg=CoordSystemMatchEpsg(<projektsioon>) : <epsg>
BuilderFunctionCoordSystemMatchEpsgBase=CoordSystemMatchEpsgBase(<projektsioon>) : <epsg>
BuilderFunctionCoordSystemOverride=CoordSystemOverride(<projektsioon>, <json>) : <projektsioon>
BuilderFunctionCoordSystemParse=CoordSystemParse(<sõne>) : <projektsioon>
BuilderFunctionCoordSystemParseEpsg=CoordSystemParseEpsg(<projektsioon>) : <epsg>
BuilderFunctionCoordSystemParseOverrides=CoordSystemParseOverrides(<projektsioon>) : <json>
BuilderFunctionCoordSystemParseSrid=CoordSystemParseSrid(<projektsioon>) : <srid>
BuilderFunctionCoordSystemParseSridSubtype=CoordSystemParseSridSubtype(<projektsioon>) : <alamtüüp>
BuilderFunctionCoordSystemPlain=CoordSystemPlain(<projektsioon>) : <projektsioon>
BuilderFunctionCoordSystems=CoordSystems() : <tabel>
BuilderFunctionCoordSystemScaleXY=CoordSystemScaleXY(<projektsioon>) : <arvx2>
BuilderFunctionCoordSystemScaleXYToUnit=CoordSystemScaleXYToUnit(<projektsioon>, <ühik>) : <arvx2>
BuilderFunctionCoordSystemScaleXYZ=CoordSystemScaleXYZ(<projektsioon>, <tingimataMeetrites>) : <mastaabitegurx3>
BuilderFunctionCoordSystemScaleXYZBounds=CoordSystemScaleXYZBounds(<projektsioon>, <tingimataMeetrites>, <kastx4>) : <mastaabitegurx3>
BuilderFunctionCoordSystemTypeParameters=CoordSystemTypeParameters(<projektsioon>, <mastaabiJaNihketeguritega>) : <tabel>
BuilderFunctionCoordSystemTypes=CoordSystemTypes() : <tabel>
BuilderFunctionCoordSystemWkt=CoordSystemWkt(<projektsioon>, <täpne?>) : <wkt>
BuilderFunctionCoordSystemWkt2=CoordSystemWkt2(<projektsioon>, <täpne?>) : <wkt2>
BuilderFunctionCoordSystemXml=CoordSystemXml(<projektsioon>) : <xml>
BuilderFunctionCoordTransform=CoordTransform(<manifold>) : <teisendus>
BuilderFunctionCoordTransformChoices=CoordTransformChoices(<milleks>, <millest>) : <tabel>
BuilderFunctionCoordTransformEpsg=CoordTransformEpsg(<epsg>) : <teisendus>
BuilderFunctionCoordTransforms=CoordTransforms() : <tabel>
BuilderFunctionCoordTransformTypeParameters=CoordTransformTypeParameters(<teisendus>) : <tabel>
BuilderFunctionCoordTransformTypes=CoordTransformTypes() : <tabel>
BuilderFunctionCoordUnit=CoordUnit(<manifold>) : <ühik>
BuilderFunctionCoordUnitByName=CoordUnitByName(<nimi>) : <ühik>
BuilderFunctionCoordUnitDefault=CoordUnitDefault() : <ühik>
BuilderFunctionCoordUnitDefaultLatLon=CoordUnitDefaultLatLon() : <ühik>
BuilderFunctionCoordUnitEpsg=CoordUnitEpsg(<epsg>) : <ühik>
BuilderFunctionCoordUnits=CoordUnits() : <tabel>
BuilderFunctionCoordUnitScale=CoordUnitScale(<ühik>) : <mastaabitegur>
BuilderFunctionCorr=Corr(<arv>, <arv>) : <arv>
BuilderFunctionCos=Cos(<radiaanmõõt>) : <arv>
BuilderFunctionCosh=Cosh(<radiaanmõõt>) : <arv>
BuilderFunctionCount=Count(<väärtus>) : <arv>
BuilderFunctionCovar=Covar(<arv>, <arv>) : <arv>
BuilderFunctionCovarPop=CovarPop(<arv>, <arv>) : <arv>
BuilderFunctionDataHash=DataHash(<väärtus>) : <räsi>
BuilderFunctionDataLength=DataLength(<väärtus>) : <arv>
BuilderFunctionDateTimeAddDays=DateTimeAddDays(<kuupäev>, <päev>) : <kuupäev>
BuilderFunctionDateTimeClearTime=DateTimeClearTime(<kuupäev>) : <kuupäev>
BuilderFunctionDateTimeCurrent=DateTimeCurrent() : <kuupäev>
BuilderFunctionDateTimeCurrentRef=DateTimeCurrentRef(<sõltuvus>) : <kuupäev>
BuilderFunctionDateTimeDay=DateTimeDay(<kuupäev>) : <arv>
BuilderFunctionDateTimeDifferenceDays=DateTimeDifferenceDays(<algusKuupäev>, <lõppKuupäev>) : <päev>
BuilderFunctionDateTimeHour=DateTimeHour(<kuupäev>) : <arv>
BuilderFunctionDateTimeMake=DateTimeMake(<aasta>, <kuu>, <päev>) : <kuupäev>
BuilderFunctionDateTimeMakeFull=DateTimeMakeFull(<aasta>, <kuu>, <päev>, <tund>, <minut>, <sekund>, <millisekund>) : <kuupäev>
BuilderFunctionDateTimeMillisecond=DateTimeMillisecond(<kuupäev>) : <arv>
BuilderFunctionDateTimeMinute=DateTimeMinute(<kuupäev>) : <arv>
BuilderFunctionDateTimeMonth=DateTimeMonth(<kuupäev>) : <arv>
BuilderFunctionDateTimeSecond=DateTimeSecond(<kuupäev>) : <arv>
BuilderFunctionDateTimeWeek=DateTimeWeek(<kuupäev>, <nädalAlgab>) : <arv>
BuilderFunctionDateTimeWeekDay=DateTimeWeekDay(<kuupäev>, <nädalAlgab>) : <arv>
BuilderFunctionDateTimeYear=DateTimeYear(<kuupäev>) : <arv>
BuilderFunctionDateTimeYearDay=DateTimeYearDay(<kuupäev>) : <arv>
BuilderFunctionDateTimeYearLeap=DateTimeYearLeap(<kuupäev>) : <tõeväärtus>
BuilderFunctionDiversity=Diversity(<arv>) : <arv>
BuilderFunctionDiversityIndex=DiversityIndex(<arv>) : <arv>
BuilderFunctionErf=Erf(<arv>) : <arv>
BuilderFunctionErfc=Erfc(<arv>) : <arv>
BuilderFunctionExp=Exp(<arv>) : <arv>
BuilderFunctionExp10=Exp10(<arv>) : <arv>
BuilderFunctionExp2=Exp2(<arv>) : <arv>
BuilderFunctionExpm1=Expm1(<arv>) : <arv>
BuilderFunctionFirst=First(<väärtus>) : <väärtus>
BuilderFunctionFirstNonNull=FirstNonNull(<väärtus>) : <väärtus>
BuilderFunctionFloor=Floor(<arv>) : <arv>
BuilderFunctionFloorDecs=FloorDecs(<arv>, <kümnendkohti>) : <arv>
BuilderFunctionFract=Fract(<arv>) : <arv>
BuilderFunctionFractDecs=FractDecs(<arv>, <kümnendkohti>) : <arv>
BuilderFunctionGeocodeAddress=GeocodeAddress(<andmeläte>, <aadress>) : <arvx2>
BuilderFunctionGeocodeAddressMatches=GeocodeAddressMatches(<andmeläte>, <aadress>) : <tabel>
BuilderFunctionGeocodeAddressSupported=GeocodeAddressSupported(<andmeläte>) : <tõeväärtus>
BuilderFunctionGeocodeLocationMatches=GeocodeLocationMatches(<andmeläte>, <arvx2>) : <tabel>
BuilderFunctionGeocodeLocationSupported=GeocodeLocationSupported(<andmeläte>) : <tõeväärtus>
BuilderFunctionGeocodeSearchMatches=GeocodeSearchMatches(<andmeläte>, <keskpunktx2>, <raadius>, <aadress>, <filter>) : <tabel>
BuilderFunctionGeocodeSearchRectMatches=GeocodeSearchRectMatches(<andmeläte>, <kastx4>, <aadress>, <filter>) : <tabel>
BuilderFunctionGeocodeSearchSupported=GeocodeSearchSupported(<andmeläte>) : <tõeväärtus>
BuilderFunctionGeomAdjacent=GeomAdjacent(<ruumikuju>, <ruumikuju>, <tolerants>) : <tõeväärtus>
BuilderFunctionGeomArea=GeomArea(<ruumikuju>, <tolerants>) : <arv>
BuilderFunctionGeomAreaGeo=GeomAreaGeo(<ruumikuju>, <pikempooltelg>, <ekstentrilisus>, <tolerants>) : <arv>
BuilderFunctionGeomBearing=GeomBearing(<ruumikuju>) : <arv>
BuilderFunctionGeomBearingGeo=GeomBearingGeo(<ruumikuju>, <pikempooltelg>, <ekstentrilisus>) : <arv>
BuilderFunctionGeomBearingPoint=GeomBearingPoint(<arvx2>, <arvx2>) : <arv>
BuilderFunctionGeomBearingPointGeo=GeomBearingPointGeo(<arvx2>, <arvx2>, <pikempooltelg>, <ekstentrilisus>) : <arv>
BuilderFunctionGeomBoundedAreas=GeomBoundedAreas(<ruumikuju>, <tolerants>) : <tabel>
BuilderFunctionGeomBounds=GeomBounds(<ruumikuju>) : <ruumikuju>
BuilderFunctionGeomBoundsCircle=GeomBoundsCircle(<ruumikuju>, <tolerants>) : <ruumikuju>
BuilderFunctionGeomBoundsRect=GeomBoundsRect(<ruumikuju>) : <kastx4>
BuilderFunctionGeomBoundsRectRotated=GeomBoundsRectRotated(<ruumikuju>, <tolerants>) : <ruumikuju>
BuilderFunctionGeomBoundsX=GeomBoundsX(<ruumikuju>) : <minmaksx2>
BuilderFunctionGeomBoundsY=GeomBoundsY(<ruumikuju>) : <minmaksx2>
BuilderFunctionGeomBoundsZ=GeomBoundsZ(<ruumikuju>) : <minmaksx2>
BuilderFunctionGeomBranch=GeomBranch(<ruumikuju>, <haru>) : <ruumikuju>
BuilderFunctionGeomBranchCount=GeomBranchCount(<ruumikuju>) : <arv>
BuilderFunctionGeomBranchFirst=GeomBranchFirst(<ruumikuju>, <haru>) : <arv>
BuilderFunctionGeomBranchLast=GeomBranchLast(<ruumikuju>, <haru>) : <arv>
BuilderFunctionGeomBuffer=GeomBuffer(<ruumikuju>, <laius>, <tolerants>) : <ruumikuju>
BuilderFunctionGeomCenter=GeomCenter(<ruumikuju>, <tolerants>) : <arvx2>
BuilderFunctionGeomCenterInner=GeomCenterInner(<ruumikuju>, <tolerants>) : <arvx2>
BuilderFunctionGeomCenterWeight=GeomCenterWeight(<ruumikuju>, <tolerants>) : <arvx2>
BuilderFunctionGeomClip=GeomClip(<ruumikuju>, <kärbi>, <väljast?>, <tolerants>) : <ruumikuju>
BuilderFunctionGeomContains=GeomContains(<ruumikuju>, <ruumikuju>, <tolerants>) : <tõeväärtus>
BuilderFunctionGeomConvertToArea=GeomConvertToArea(<ruumikuju>) : <ruumikuju>
BuilderFunctionGeomConvertToLine=GeomConvertToLine(<ruumikuju>) : <ruumikuju>
BuilderFunctionGeomConvertToPoint=GeomConvertToPoint(<ruumikuju>, <säilitaHarud>) : <ruumikuju>
BuilderFunctionGeomConvexHull=GeomConvexHull(<ruumikuju>, <lubaNullpinnagaAla>, <tolerants>) : <ruumikuju>
BuilderFunctionGeomCoordCount=GeomCoordCount(<ruumikuju>) : <arv>
BuilderFunctionGeomCoordLine=GeomCoordLine(<ruumikuju>, <positsioon>) : <arvx2>
BuilderFunctionGeomCoordX=GeomCoordX(<ruumikuju>, <mitmes>) : <arv>
BuilderFunctionGeomCoordXY=GeomCoordXY(<ruumikuju>, <mitmes>) : <arvx2>
BuilderFunctionGeomCoordXYZ=GeomCoordXYZ(<ruumikuju>, <mitmes>) : <arvx3>
BuilderFunctionGeomCoordY=GeomCoordY(<ruumikuju>, <mitmes>) : <arv>
BuilderFunctionGeomCoordZ=GeomCoordZ(<ruumikuju>, <mitmes>) : <arv>
BuilderFunctionGeomCurveCount=GeomCurveCount(<ruumikuju>, <kõveratüüp>) : <arv>
BuilderFunctionGeomDistance=GeomDistance(<ruumikuju>, <ruumikuju>, <tolerants>) : <arv>
BuilderFunctionGeomDistancePoint=GeomDistancePoint(<arvx2>, <arvx2>) : <arv>
BuilderFunctionGeomDistancePoint3=GeomDistancePoint3(<arvx3>, <arvx3>) : <arv>
BuilderFunctionGeomDistancePointGeo=GeomDistancePointGeo(<arvx2>, <arvx2>, <pikempooltelg>, <ekstentrilisus>) : <arv>
BuilderFunctionGeomFlip=GeomFlip(<ruumikuju>, <horis>, <vert>) : <ruumikuju>
BuilderFunctionGeomGml=GeomGml(<ruumikuju>, <projektsioon>) : <gml>
BuilderFunctionGeomHasCurves=GeomHasCurves(<ruumikuju>) : <tõeväärtus>
BuilderFunctionGeomHasZ=GeomHasZ(<ruumikuju>) : <tõeväärtus>
BuilderFunctionGeomInflateRect=GeomInflateRect(<kastx4>, <venitax2>) : <kastx4>
BuilderFunctionGeomInflateRectTileSize=GeomInflateRectTileSize(<kastx4>, <tailimõõdudx2>) : <kastx4>
BuilderFunctionGeomIntersectLines=GeomIntersectLines(<ruumikuju>, <ruumikuju>, <tolerants>) : <ruumikuju>
BuilderFunctionGeomIntersects=GeomIntersects(<ruumikuju>, <ruumikuju>, <tolerants>) : <tõeväärtus>
BuilderFunctionGeomIsArea=GeomIsArea(<ruumikuju>) : <tõeväärtus>
BuilderFunctionGeomIsLine=GeomIsLine(<ruumikuju>) : <tõeväärtus>
BuilderFunctionGeomIsLineClosed=GeomIsLineClosed(<ruumikuju>) : <tõeväärtus>
BuilderFunctionGeomIsNormalized=GeomIsNormalized(<ruumikuju>) : <tõeväärtus>
BuilderFunctionGeomIsPoint=GeomIsPoint(<ruumikuju>) : <tõeväärtus>
BuilderFunctionGeomJsonGeo=GeomJsonGeo(<ruumikuju>, <projektsioon>) : <json>
BuilderFunctionGeomLength=GeomLength(<ruumikuju>, <tolerants>) : <arv>
BuilderFunctionGeomLengthGeo=GeomLengthGeo(<ruumikuju>, <pikempooltelg>, <ekstentrilisus>, <tolerants>) : <arv>
BuilderFunctionGeomLinearize=GeomLinearize(<ruumikuju>, <tolerants>, <limiit>) : <ruumikuju>
BuilderFunctionGeomMakeCircle=GeomMakeCircle(<arvx2>, <raadius>) : <ruumikuju>
BuilderFunctionGeomMakePoint=GeomMakePoint(<arvx2>) : <ruumikuju>
BuilderFunctionGeomMakePoint3=GeomMakePoint3(<arvx3>) : <ruumikuju>
BuilderFunctionGeomMakeRect=GeomMakeRect(<kastx4>) : <ruumikuju>
BuilderFunctionGeomMakeRectDiagonal=GeomMakeRectDiagonal(<arvx2>, <arvx2>) : <ruumikuju>
BuilderFunctionGeomMakeSegment=GeomMakeSegment(<arvx2>, <arvx2>) : <ruumikuju>
BuilderFunctionGeomMakeSegment3=GeomMakeSegment3(<arvx3>, <arvx3>) : <ruumikuju>
BuilderFunctionGeomMakeTriangle=GeomMakeTriangle(<arvx2>, <arvx2>, <arvx2>) : <ruumikuju>
BuilderFunctionGeomMakeTriangle3=GeomMakeTriangle3(<arvx3>, <arvx3>, <arvx3>) : <ruumikuju>
BuilderFunctionGeomMergeAreas=GeomMergeAreas(<ruumikuju>) : <ruumikuju>
BuilderFunctionGeomMergeLines=GeomMergeLines(<ruumikuju>) : <ruumikuju>
BuilderFunctionGeomMergePoints=GeomMergePoints(<ruumikuju>) : <ruumikuju>
BuilderFunctionGeomNormalize=GeomNormalize(<ruumikuju>, <tolerants>) : <ruumikuju>
BuilderFunctionGeomNormalizeTopology=GeomNormalizeTopology(<vektorjoonis>, <tolerants>) : <tabel>
BuilderFunctionGeomOverlayAdjacent=GeomOverlayAdjacent(<vektorjoonis>, <ülekate>, <tolerants>) : <tabel>
BuilderFunctionGeomOverlayAdjacentFilter=GeomOverlayAdjacentFilter(<vektorjoonis>, <ülekate>, <tolerants>) : <tabel>
BuilderFunctionGeomOverlayAdjacentFilterPar=GeomOverlayAdjacentFilterPar(<vektorjoonis>, <ülekate>, <tolerants>, <konf>) : <tabel>
BuilderFunctionGeomOverlayAdjacentPar=GeomOverlayAdjacentPar(<vektorjoonis>, <ülekate>, <tolerants>, <konf>) : <tabel>
BuilderFunctionGeomOverlayContained=GeomOverlayContained(<vektorjoonis>, <ülekate>, <tolerants>) : <tabel>
BuilderFunctionGeomOverlayContainedFilter=GeomOverlayContainedFilter(<vektorjoonis>, <ülekate>, <tolerants>) : <tabel>
BuilderFunctionGeomOverlayContainedFilterPar=GeomOverlayContainedFilterPar(<vektorjoonis>, <ülekate>, <tolerants>, <konf>) : <tabel>
BuilderFunctionGeomOverlayContainedPar=GeomOverlayContainedPar(<vektorjoonis>, <ülekate>, <tolerants>, <konf>) : <tabel>
BuilderFunctionGeomOverlayContaining=GeomOverlayContaining(<vektorjoonis>, <ülekate>, <tolerants>) : <tabel>
BuilderFunctionGeomOverlayContainingFilter=GeomOverlayContainingFilter(<vektorjoonis>, <ülekate>, <tolerants>) : <tabel>
BuilderFunctionGeomOverlayContainingFilterPar=GeomOverlayContainingFilterPar(<vektorjoonis>, <ülekate>, <tolerants>, <konf>) : <tabel>
BuilderFunctionGeomOverlayContainingPar=GeomOverlayContainingPar(<vektorjoonis>, <ülekate>, <tolerants>, <konf>) : <tabel>
BuilderFunctionGeomOverlayIntersecting=GeomOverlayIntersecting(<vektorjoonis>, <ülekate>, <tolerants>) : <tabel>
BuilderFunctionGeomOverlayIntersectingFilter=GeomOverlayIntersectingFilter(<vektorjoonis>, <ülekate>, <tolerants>) : <tabel>
BuilderFunctionGeomOverlayIntersectingFilterPar=GeomOverlayIntersectingFilterPar(<vektorjoonis>, <ülekate>, <tolerants>, <konf>) : <tabel>
BuilderFunctionGeomOverlayIntersectingPar=GeomOverlayIntersectingPar(<vektorjoonis>, <ülekate>, <tolerants>, <konf>) : <tabel>
BuilderFunctionGeomOverlayTopologyIdentity=GeomOverlayTopologyIdentity(<vektorjoonis>, <ülekate>, <tolerants>) : <tabel>
BuilderFunctionGeomOverlayTopologyIdentityPar=GeomOverlayTopologyIdentityPar(<vektorjoonis>, <ülekate>, <tolerants>, <konf>) : <tabel>
BuilderFunctionGeomOverlayTopologyIntersect=GeomOverlayTopologyIntersect(<vektorjoonis>, <ülekate>, <tolerants>) : <tabel>
BuilderFunctionGeomOverlayTopologyIntersectPar=GeomOverlayTopologyIntersectPar(<vektorjoonis>, <ülekate>, <tolerants>, <konf>) : <tabel>
BuilderFunctionGeomOverlayTopologyUnion=GeomOverlayTopologyUnion(<vektorjoonis>, <ülekate>, <tolerants>) : <tabel>
BuilderFunctionGeomOverlayTopologyUnionPar=GeomOverlayTopologyUnionPar(<vektorjoonis>, <ülekate>, <tolerants>, <konf>) : <tabel>
BuilderFunctionGeomOverlayTopologyUpdate=GeomOverlayTopologyUpdate(<vektorjoonis>, <ülekate>, <tolerants>) : <tabel>
BuilderFunctionGeomOverlayTopologyUpdatePar=GeomOverlayTopologyUpdatePar(<vektorjoonis>, <ülekate>, <tolerants>, <konf>) : <tabel>
BuilderFunctionGeomOverlayTouching=GeomOverlayTouching(<vektorjoonis>, <ülekate>, <tolerants>) : <tabel>
BuilderFunctionGeomOverlayTouchingFilter=GeomOverlayTouchingFilter(<vektorjoonis>, <ülekate>, <tolerants>) : <tabel>
BuilderFunctionGeomOverlayTouchingFilterPar=GeomOverlayTouchingFilterPar(<vektorjoonis>, <ülekate>, <tolerants>, <konf>) : <tabel>
BuilderFunctionGeomOverlayTouchingPar=GeomOverlayTouchingPar(<vektorjoonis>, <ülekate>, <tolerants>, <konf>) : <tabel>
BuilderFunctionGeomOverlayWithin=GeomOverlayWithin(<vektorjoonis>, <ülekate>, <kaugus>, <tolerants>) : <tabel>
BuilderFunctionGeomOverlayWithinFilter=GeomOverlayWithinFilter(<vektorjoonis>, <ülekate>, <kaugus>, <tolerants>) : <tabel>
BuilderFunctionGeomOverlayWithinFilterPar=GeomOverlayWithinFilterPar(<vektorjoonis>, <ülekate>, <kaugus>, <tolerants>, <konf>) : <tabel>
BuilderFunctionGeomOverlayWithinPar=GeomOverlayWithinPar(<vektorjoonis>, <ülekate>, <kaugus>, <tolerants>, <konf>) : <tabel>
BuilderFunctionGeomPartLine=GeomPartLine(<joonobjekt>, <alates>, <kuni>) : <ruumikuju>
BuilderFunctionGeomRadius=GeomRadius(<ruumikuju>, <tolerants>) : <arv>
BuilderFunctionGeomRadiusGeo=GeomRadiusGeo(<ruumikuju>, <pikempooltelg>, <ekstentrilisus>, <tolerants>) : <arv>
BuilderFunctionGeomRemoveCurves=GeomRemoveCurves(<ruumikuju>) : <ruumikuju>
BuilderFunctionGeomRemoveZ=GeomRemoveZ(<ruumikuju>) : <ruumikuju>
BuilderFunctionGeomReverseLine=GeomReverseLine(<ruumikuju>) : <ruumikuju>
BuilderFunctionGeomRotate=GeomRotate(<ruumikuju>, <keskpunktx2>, <nurk>) : <ruumikuju>
BuilderFunctionGeomScale=GeomScale(<ruumikuju>, <mastaabitegurx2>) : <ruumikuju>
BuilderFunctionGeomScaleCentered=GeomScaleCentered(<ruumikuju>, <mastaabitegurx2>, <keskpunktx2>) : <ruumikuju>
BuilderFunctionGeomScaleRev=GeomScaleRev(<ruumikuju>, <mastaabitegurx2>) : <ruumikuju>
BuilderFunctionGeomScaleShift=GeomScaleShift(<ruumikuju>, <mastaabitegurx2>, <nihex2>) : <ruumikuju>
BuilderFunctionGeomScaleShiftZ=GeomScaleShiftZ(<ruumikuju>, <mastaabitegur>, <nihe>) : <ruumikuju>
BuilderFunctionGeomSegmentize=GeomSegmentize(<ruumikuju>, <pikkus>) : <ruumikuju>
BuilderFunctionGeomSetZ=GeomSetZ(<ruumikuju>, <z>) : <ruumikuju>
BuilderFunctionGeomShift=GeomShift(<ruumikuju>, <nihex2>) : <ruumikuju>
BuilderFunctionGeomSmooth=GeomSmooth(<ruumikuju>, <pikkus>) : <ruumikuju>
BuilderFunctionGeomSnapToGrid=GeomSnapToGrid(<ruumikuju>, <arvx2>) : <ruumikuju>
BuilderFunctionGeomToBranches=GeomToBranches(<ruumikuju>) : <tabel>
BuilderFunctionGeomToConvex=GeomSplitToConvex(<ala>, <tolerants>) : <alad>
BuilderFunctionGeomToConvexPar=GeomSplitToConvexPar(<ala>, <tolerants>, <konf>) : <alad>
BuilderFunctionGeomToCoords=GeomToCoords(<ruumikuju>) : <tabel>
BuilderFunctionGeomToCoordsLineSequence=GeomToCoordsLineSequence(<joonobjekt>, <alates>, <kuni>, <samm>) : <tabel>
BuilderFunctionGeomToParts=GeomToParts(<ruumikuju>, <jaotaja>, <tolerants>) : <tabel>
BuilderFunctionGeomToPartsLineSequence=GeomToPartsLineSequence(<joonobjekt>, <alates>, <kuni>, <samm>) : <tabel>
BuilderFunctionGeomToSegments=GeomToSegments(<ruumikuju>) : <tabel>
BuilderFunctionGeomToShapes=GeomToShapes(<ruumikuju>) : <tabel>
BuilderFunctionGeomToShapesEsri=GeomToShapesEsri(<ruumikuju>) : <tabel>
BuilderFunctionGeomTouches=GeomTouches(<ruumikuju>, <ruumikuju>, <tolerants>) : <tõeväärtus>
BuilderFunctionGeomTriangulate=GeomTriangulate(<ruumikuju>, <tolerants>) : <alad>
BuilderFunctionGeomTriangulatePar=GeomTriangulatePar(<ruumikuju>, <tolerants>, <konf>) : <alad>
BuilderFunctionGeomTriangulateLines=GeomTriangulateLines(<ruumikuju>, <tolerants>) : <jooned>
BuilderFunctionGeomTriangulateLinesPar=GeomTriangulateLinesPar(<ruumikuju>, <tolerants>, <konf>) : <jooned>
BuilderFunctionGeomType=GeomType(<ruumikuju>) : <väärtus>
BuilderFunctionGeomUnionAreas=GeomUnionAreas(<ruumikuju>) : <ruumikuju>
BuilderFunctionGeomUnionRects=GeomUnionRects(<kastx4>) : <kastx4>
BuilderFunctionGeomVoronoi=GeomVoronoi(<punktid>, <äärisx2>, <tolerants>) : <alad>
BuilderFunctionGeomVoronoiPar=GeomVoronoiPar(<punktid>, <äärisx2>, <tolerants>, <konf>) : <alad>
BuilderFunctionGeomVoronoiLines=GeomVoronoiLines(<punktid>, <äärisx2>, <tolerants>) : <jooned>
BuilderFunctionGeomVoronoiLinesPar=GeomVoronoiLinesPar(<punktid>, <äärisx2>, <tolerants>, <konf>) : <jooned>
BuilderFunctionGeomVoronoiPoints=GeomVoronoiPoints(<punktid>, <äärisx2>, <tolerants>) : <punktid>
BuilderFunctionGeomVoronoiPointsPar=GeomVoronoiPointsPar(<punktid>, <äärisx2>, <tolerants>, <konf>) : <punktid>
BuilderFunctionGeomWithin=GeomWithin(<ruumikuju>, <ruumikuju>, <kaugus>, <tolerants>) : <tõeväärtus>
BuilderFunctionGeomWkb=GeomWkb(<ruumikuju>) : <wkb>
BuilderFunctionGeomWkt=GeomWkt(<ruumikuju>) : <wkt>
BuilderFunctionHypot=Hypot(<x>, <y>) : <arv>
BuilderFunctionJ0=J0(<arv>) : <arv>
BuilderFunctionJ1=J1(<arv>) : <arv>
BuilderFunctionJn=Jn(<järk>, <arv>) : <arv>
BuilderFunctionJoinAnd=JoinAnd(<tõeväärtus>) : <tõeväärtus>
BuilderFunctionJoinBitAnd=JoinBitAnd(<arv>) : <arv>
BuilderFunctionJoinBitOr=JoinBitOr(<arv>) : <arv>
BuilderFunctionJoinBitXor=JoinBitXor(<arv>) : <arv>
BuilderFunctionJoinOr=JoinOr(<tõeväärtus>) : <tõeväärtus>
BuilderFunctionJoinXor=JoinXor(<tõeväärtus>) : <tõeväärtus>
BuilderFunctionLast=Last(<väärtus>) : <väärtus>
BuilderFunctionLastNonNull=LastNonNull(<väärtus>) : <väärtus>
BuilderFunctionLgamma=Lgamma(<arv>) : <arv>
BuilderFunctionLog=Log(<arv>) : <arv>
BuilderFunctionLog10=Log10(<arv>) : <arv>
BuilderFunctionLog1p=Log1p(<arv>) : <arv>
BuilderFunctionLog2=Log2(<arv>) : <arv>
BuilderFunctionMajor=Major(<arv>) : <arv>
BuilderFunctionMax=Max(<väärtus>) : <väärtus>
BuilderFunctionMedian=Median(<väärtus>) : <väärtus>
BuilderFunctionMin=Min(<väärtus>) : <väärtus>
BuilderFunctionNullIf=NullIf(<väärtus>, <väärtus>) : <väärtus>
BuilderFunctionPercentile=Percentile(<väärtus>, <protsentiil>) : <väärtus>
BuilderFunctionPow=Pow(<astendatav>, <astendaja>) : <arv>
BuilderFunctionPragmaValue=PragmaValue(<pragma>) : <sõne>
BuilderFunctionRandom=Random() : <arv>
BuilderFunctionRandomHash=RandomHash(<väärtus>) : <räsi>
BuilderFunctionRandomInt=RandomInt(<vahemik>) : <täisarv>
BuilderFunctionRandomIntHash=RandomIntHash(<vahemik>, <väärtus>) : <täisarv>
BuilderFunctionRandomIntRef=RandomIntRef(<vahemik>, <sõltuvus>) : <täisarv>
BuilderFunctionRandomRef=RandomRef(<sõltuvus>) : <arv>
BuilderFunctionRcbrt=Rcbrt(<arv>) : <arv>
BuilderFunctionRound=Round(<arv>) : <arv>
BuilderFunctionRoundDecs=RoundDecs(<arv>, <kümnendkohti>) : <arv>
BuilderFunctionRsqrt=Rsqrt(<arv>) : <arv>
BuilderFunctionSelection=Selection(<tabel>, <valitud?>) : <tabel>
BuilderFunctionSelectionIsEmpty=SelectionIsEmpty(<tabel>) : <tõeväärtus>
BuilderFunctionSelectionIsEmptyWindow=SelectionIsEmptyWindow(<tabel>, <aken>, <kiht>) : <tõeväärtus>
BuilderFunctionSelectionIsInverted=SelectionIsInverted(<tabel>) : <tõeväärtus>
BuilderFunctionSelectionIsInvertedWindow=SelectionIsInvertedWindow(<tabel>, <aken>, <kiht>) : <tõeväärtus>
BuilderFunctionSelectionKeys=SelectionKeys(<tabel>) : <tabel>
BuilderFunctionSelectionKeysWindow=SelectionKeysWindow(<tabel>, <aken>, <kiht>) : <tabel>
BuilderFunctionSelectionReplace=SelectionReplace(<tabel>, <id-d>, <valitud?>) : <arv>
BuilderFunctionSelectionReplaceWindow=SelectionReplaceWindow(<tabel>, <aken>, <kiht>, <id-d>, <valitud?>) : <arv>
BuilderFunctionSelectionWindow=SelectionWindow(<tabel>, <aken>, <kiht>, <valitud?>) : <tabel>
BuilderFunctionSign=Sign(<arv>) : <arv>
BuilderFunctionSin=Sin(<radiaanmõõt>) : <arv>
BuilderFunctionSinh=Sinh(<radiaanmõõt>) : <arv>
BuilderFunctionSqrt=Sqrt(<arv>) : <arv>
BuilderFunctionStDev=StDev(<arv>) : <arv>
BuilderFunctionStDevPop=StDevPop(<arv>) : <arv>
BuilderFunctionStringBinaryBase64=StringBinaryBase64(<sõne>) : <baidijada>
BuilderFunctionStringBinaryHex=StringBinaryHex(<sõne>) : <baidijada>
BuilderFunctionStringCompareCollate=StringCompareCollate(<sõne>, <sõne>, <sorteerimiskood>) : <arv>
BuilderFunctionStringCompareKeyCollate=StringCompareKeyCollate(<sõne>, <sorteerimiskood>) : <arv>
BuilderFunctionStringConcat=StringConcat(<sõne>, <eraldaja>, <sõne>) : <sõne>
BuilderFunctionStringContains=StringContains(<sõne>, <alamsõne>) : <tõeväärtus>
BuilderFunctionStringContainsCollate=StringContainsCollate(<sõne>, <alamsõne>, <sorteerimiskood>) : <tõeväärtus>
BuilderFunctionStringDateTime=StringDateTime(<sõne>, <keel>) : <kuupäev>
BuilderFunctionStringDecrypt=StringDecrypt(<krüptitudSõne>, <võti>) : <sõne>
BuilderFunctionStringEmailValid=StringEmailValid(<email>) : <tõeväärtus>
BuilderFunctionStringEncrypt=StringEncrypt(<sõne>, <võti>) : <krüptitudSõne>
BuilderFunctionStringEnd=StringEnd(<sõne>, <pikkus>) : <sõne>
BuilderFunctionStringEndsWith=StringEndsWith(<sõne>, <alamsõne>) : <tõeväärtus>
BuilderFunctionStringEndsWithCollate=StringEndsWithCollate(<sõne>, <alamsõne>, <sorteerimiskood>) : <tõeväärtus>
BuilderFunctionStringEscape=StringEscape(<sõne>, <paomärk>) : <sõne>
BuilderFunctionStringEscapeEncode=StringEscapeEncode(<sõne>, <paomärk>, <printimatudPakku>) : <sõne>
BuilderFunctionStringEscapeJson=StringEscapeJson(<sõne>) : <sõne>
BuilderFunctionStringFind=StringFind(<sõne>, <alamsõne>) : <arv>
BuilderFunctionStringFindCollate=StringFindCollate(<sõne>, <alamsõne>, <sorteerimiskood>) : <arv>
BuilderFunctionStringFindNth=StringFindNth(<sõne>, <alamsõne>, <mitmes>) : <arv>
BuilderFunctionStringFindNthCollate=StringFindNthCollate(<sõne>, <alamsõne>, <mitmes>, <sorteerimiskood>) : <arv>
BuilderFunctionStringFormat=StringFormat(<sõne>, <formaat>, <keel>) : <sõne>
BuilderFunctionStringFormatBinary=StringFormatBinary(<väärtus>, <formaat>, <keel>) : <sõne>
BuilderFunctionStringFormatBoolean=StringFormatBoolean(<tõeväärtus>, <formaat>) : <sõne>
BuilderFunctionStringFormatDateTime=StringFormatDateTime(<kuupäev>, <formaat>, <keel>) : <sõne>
BuilderFunctionStringFormatDurationDays=StringFormatDurationDays(<päevad>, <formaat>, <keel>) : <sõne>
BuilderFunctionStringFormatDurationSeconds=StringFormatDurationSeconds(<sekundid>, <formaat>, <keel>) : <sõne>
BuilderFunctionStringFormatGeom=StringFormatGeom(<geom>, <formaat>, <keel>) : <sõne>
BuilderFunctionStringFormatNumber=StringFormatNumber(<arv>, <formaat>, <keel>) : <sõne>
BuilderFunctionStringFormatTile=StringFormatTile(<tail>, <formaat>, <keel>) : <sõne>
BuilderFunctionStringFormatUuid=StringFormatUuid(<uuid>, <formaat>) : <sõne>
BuilderFunctionStringFormatVector=StringFormatVector(<arvxN>, <formaat>, <keel>) : <sõne>
BuilderFunctionStringGmlCoordSystem=StringGmlCoordSystem(<gml>) : <projektsioon>
BuilderFunctionStringGmlGeom=StringGmlGeom(<gml>) : <ruumikuju>
BuilderFunctionStringJoinTokens=StringJoinTokens(<sõne>, <eraldaja>) : <sõne>
BuilderFunctionStringJsonBoolean=StringJsonBoolean(<json>, <nimi>, <täpne?>) : <väärtus>
BuilderFunctionStringJsonGeoCoordSystem=StringJsonGeoCoordSystem(<json>) : <projektsioon>
BuilderFunctionStringJsonGeoGeom=StringJsonGeoGeom(<json>) : <ruumikuju>
BuilderFunctionStringJsonNumber=StringJsonNumber(<json>, <nimi>, <täpne?>) : <väärtus>
BuilderFunctionStringJsonObject=StringJsonObject(<json>, <nimi>) : <väärtus>
BuilderFunctionStringJsonTile=StringJsonTile(<json>, <cx>, <cy>, <kanaleid>, <täpne?>) : <tail>
BuilderFunctionStringJsonValue=StringJsonValue(<json>, <nimi>, <täpne?>) : <väärtus>
BuilderFunctionStringJsonValueVector=StringJsonArrayValue(<json>, <indeks>) : <sõne>
BuilderFunctionStringJsonVector=StringJsonArray(<json>, <nimi>) : <väärtus>
BuilderFunctionStringLength=StringLength(<sõne>) : <pikkus>
BuilderFunctionStringPadEnd=StringPadEnd(<sõne>, <pikkus>, <täidis>) : <sõne>
BuilderFunctionStringPadStart=StringPadStart(<sõne>, <pikkus>, <täidis>) : <sõne>
BuilderFunctionStringRegexpCount=StringRegexpCount(<sõne>, <regulaaravaldis>, <indikaatorlipud>) : <arv>
BuilderFunctionStringRegexpFind=StringRegexpFind(<sõne>, <regulaaravaldis>, <indikaatorlipud>) : <positsioon>
BuilderFunctionStringRegexpFindNth=StringRegexpFindNth(<sõne>, <regulaaravaldis>, <mitmes>, <indikaatorlipud>) : <positsioon>
BuilderFunctionStringRegexpMatches=StringRegexpMatches(<sõne>, <regulaaravaldis>, <indikaatorlipud>) : <tõeväärtus>
BuilderFunctionStringRegexpReplace=StringRegexpReplace(<sõne>, <regulaaravaldis>, <millega>, <indikaatorlipud>) : <sõne>
BuilderFunctionStringRegexpReplaceNth=StringRegexpReplaceNth(<sõne>, <regulaaravaldis>, <millega>, <mitmes>, <indikaatorlipud>) : <sõne>
BuilderFunctionStringRegexpSubstring=StringRegexpSubstring(<sõne>, <regulaaravaldis>, <indikaatorlipud>) : <sõne>
BuilderFunctionStringRegexpSubstringNth=StringRegexpSubstringNth(<sõne>, <regulaaravaldis>, <mitmes>, <indikaatorlipud>) : <sõne>
BuilderFunctionStringReplace=StringReplace(<sõne>, <mis>, <millega>) : <sõne>
BuilderFunctionStringReplaceCollate=StringReplaceCollate(<sõne>, <mis>, <millega>, <sorteerimiskood>) : <sõne>
BuilderFunctionStringReplaceNth=StringReplaceNth(<sõne>, <mis>, <millega>, <mitmes>) : <sõne>
BuilderFunctionStringReplaceNthCollate=StringReplaceNthCollate(<sõne>, <mis>, <millega>, <mitmes>, <sorteerimiskood>) : <sõne>
BuilderFunctionStringReverse=StringReverse(<sõne>) : <sõne>
BuilderFunctionStringSoundex=StringSoundex(<sõne>) : <sõne>
BuilderFunctionStringStart=StringStart(<sõne>, <pikkus>) : <sõne>
BuilderFunctionStringStartsWith=StringStartsWith(<sõne>, <alamsõne>) : <tõeväärtus>
BuilderFunctionStringStartsWithCollate=StringStartsWithCollate(<sõne>, <alamsõne>, <sorteerimiskood>) : <tõeväärtus>
BuilderFunctionStringSubstring=StringSubstring(<sõne>, <alates>) : <sõne>
BuilderFunctionStringSubstringLen=StringSubstringLen(<sõne>, <alates>, <pikkus>) : <sõne>
BuilderFunctionStringToCharacters=StringToCharacters(<sõne>) : <tabel>
BuilderFunctionStringToJsonObjectValues=StringToJsonObjectValues(<json>) : <tabel>
BuilderFunctionStringToJsonVectorValues=StringToJsonArrayValues(<json>) : <tabel>
BuilderFunctionStringToLowerCase=StringToLowerCase(<sõne>) : <sõne>
BuilderFunctionStringToLowerCaseCollate=StringToLowerCaseCollate(<sõne>, <sorteerimiskood>) : <sõne>
BuilderFunctionStringToRegexpMatches=StringToRegexpMatches(<sõne>, <regulaaravaldis>, <indikaatorlipud>) : <tabel>
BuilderFunctionStringToTitleCase=StringToTitleCase(<sõne>) : <sõne>
BuilderFunctionStringToTitleCaseCollate=StringToTitleCaseCollate(<sõne>, <sorteerimiskood>) : <sõne>
BuilderFunctionStringToTokens=StringToTokens(<sõne>, <eraldaja>) : <tabel>
BuilderFunctionStringToUpperCase=StringToUpperCase(<sõne>) : <sõne>
BuilderFunctionStringToUpperCaseCollate=StringToUpperCaseCollate(<sõne>, <sorteerimiskood>) : <sõne>
BuilderFunctionStringTranslate=StringTranslate(<sõne>, <mis>, <millega>) : <sõne>
BuilderFunctionStringTrim=StringTrim(<sõne>, <püga>) : <sõne>
BuilderFunctionStringTrimEnd=StringTrimEnd(<sõne>, <püga>) : <sõne>
BuilderFunctionStringTrimStart=StringTrimStart(<sõne>, <püga>) : <sõne>
BuilderFunctionStringUnescape=StringUnescape(<sõne>, <paomärk>) : <sõne>
BuilderFunctionStringUnescapeDecode=StringUnescapeDecode(<sõne>, <paomärk>, <printimatudPakku>) : <sõne>
BuilderFunctionStringUnescapeJson=StringUnescapeJson(<sõne>) : <sõne>
BuilderFunctionStringUrlAppend=StringUrlAppend(<url>, <urlSuhteline>) : <url>
BuilderFunctionStringUrlExtra=StringUrlExtra(<url>) : <sõne>
BuilderFunctionStringUrlHost=StringUrlHost(<url>) : <sõne>
BuilderFunctionStringUrlMake=StringUrlMake(<protokoll>, <domeen>, <port>, <kasutaja>, <parool>, <rada>, <ekstra>) : <url>
BuilderFunctionStringUrlPassword=StringUrlPassword(<url>) : <sõne>
BuilderFunctionStringUrlPath=StringUrlPath(<url>) : <sõne>
BuilderFunctionStringUrlPort=StringUrlPort(<url>) : <arv>
BuilderFunctionStringUrlScheme=StringUrlScheme(<url>) : <sõne>
BuilderFunctionStringUrlUser=StringUrlUser(<url>) : <sõne>
BuilderFunctionStringUrlValid=StringUrlValid(<url>) : <tõeväärtus>
BuilderFunctionStringWktGeom=StringWktGeom(<wkt>) : <ruumikuju>
BuilderFunctionSum=Sum(<arv>) : <arv>
BuilderFunctionSystemCpuCount=SystemCpuCount() : <arv>
BuilderFunctionSystemGpgpuCount=SystemGpgpuCount() : <arv>
BuilderFunctionSystemGpgpus=SystemGpgpus() : <tabel>
BuilderFunctionTableCache=TableCache(<tabel>, <kirjutatav?>) : <tabel>
BuilderFunctionTableCacheIndexGeoms=TableCacheIndexGeoms(<tabel>, <kirjutatav?>) : <tabel>
BuilderFunctionTan=Tan(<radiaanmõõt>) : <arv>
BuilderFunctionTanh=Tanh(<radiaanmõõt>) : <arv>
BuilderFunctionTgamma=Tgamma(<arv>) : <arv>
BuilderFunctionThreadConfig=ThreadConfig(<lõimedeArv>) : <konf>
BuilderFunctionTileAbs=TileAbs(<tail>) : <tail>
BuilderFunctionTileAcos=TileAcos(<tail>) : <tail>
BuilderFunctionTileAcosh=TileAcosh(<tail>) : <tail>
BuilderFunctionTileAsin=TileAsin(<tail>) : <tail>
BuilderFunctionTileAsinh=TileAsinh(<tail>) : <tail>
BuilderFunctionTileAspect=TileAspect(<tail>, <raadius>, <mastaabitegurx3>) : <tail>
BuilderFunctionTileAtan=TileAtan(<tail>) : <tail>
BuilderFunctionTileAtan2=TileAtan2(<y>, <x>) : <tail>
BuilderFunctionTileAtanh=TileAtanh(<tail>) : <tail>
BuilderFunctionTileBgrHcy=TileBgrHcy(<tailbgr>) : <tailhcy>
BuilderFunctionTileBgrHsi=TileBgrHsi(<tailbgr>) : <tailhsi>
BuilderFunctionTileBgrHsl=TileBgrHsl(<tailbgr>) : <tailhsl>
BuilderFunctionTileBgrHsv=TileBgrHsv(<tailbgr>) : <tailhsv>
BuilderFunctionTileCbrt=TileCbrt(<tail>) : <tail>
BuilderFunctionTileCeil=TileCeil(<tail>) : <tail>
BuilderFunctionTileCeilDecs=TileCeilDecs(<tail>, <kümnendkohti>) : <tail>
BuilderFunctionTileChannel=TileChannel(<tail>, <kanal>) : <tail>
BuilderFunctionTileChannelCopy=TileChannelCopy(<tail>, <kanal>, <algneTail>, <algneKanal>) : <tail>
BuilderFunctionTileChannelCount=TileChannelCount(<tail>) : <arv>
BuilderFunctionTileChannels=TileChannels(<tail>, <arv/arvxN>) : <tail>
BuilderFunctionTileChannelsConcat=TileChannelsConcat(<tail>, <tailKokku>) : <tail>
BuilderFunctionTileChannelsConcatFill=TileChannelsConcatFill(<tail>, <tailKokku>) : <tail>
BuilderFunctionTileClear=TileClear(<tail>) : <tail>
BuilderFunctionTileContourArea=TileContourArea(<raster>, <kanal>, <minKõrgus>, <maxKõrgus>) : <ruumikuju>
BuilderFunctionTileContourAreaPar=TileContourAreaPar(<raster>, <kanal>, <minKõrgus>, <maxKõrgus>, <konf>) : <ruumikuju>
BuilderFunctionTileContourAreas=TileContourAreas(<raster>, <kanal>, <kõrgused>, <lõhu?>) : <tabel>
BuilderFunctionTileContourAreasPar=TileContourAreasPar(<raster>, <kanal>, <kõrgused>, <lõhu?>, <konf>) : <tabel>
BuilderFunctionTileContourLine=TileContourLine(<raster>, <kanal>, <kõrgus>) : <ruumikuju>
BuilderFunctionTileContourLinePar=TileContourLinePar(<raster>, <kanal>, <kõrgus>, <konf>) : <ruumikuju>
BuilderFunctionTileContourLines=TileContourLines(<raster>, <kanal>, <kõrgused>, <lõhu?>) : <tabel>
BuilderFunctionTileContourLinesPar=TileContourLinesPar(<raster>, <kanal>, <kõrgused>, <lõhu?>, <konf>) : <tabel>
BuilderFunctionTileContrast=TileContrast(<tail>, <keskpunktiKaal>, <astendaja>) : <tail>
BuilderFunctionTileCos=TileCos(<tail>) : <tail>
BuilderFunctionTileCosh=TileCosh(<tail>) : <tail>
BuilderFunctionTileCurvGaussian=TileCurvGaussian(<tail>, <raadius>, <mastaabitegurx3>) : <tail>
BuilderFunctionTileCurvMean=TileCurvMean(<tail>, <raadius>, <mastaabitegurx3>) : <tail>
BuilderFunctionTileCurvPlan=TileCurvPlan(<tail>, <raadius>, <mastaabitegurx3>) : <tail>
BuilderFunctionTileCurvProfile=TileCurvProfile(<tail>, <raadius>, <mastaabitegurx3>) : <tail>
BuilderFunctionTileCut=TileCut(<raster>, <arvx2>) : <tail>
BuilderFunctionTileCutBorder=TileCutBorder(<raster>, <arvx2>, <äärelaius>) : <tail>
BuilderFunctionTileCutRect=TileCutRect(<raster>, <kastx4>) : <tail>
BuilderFunctionTileDistanceMake=TileDistanceMake(<raster>, <kanal>, <barjäär>) : <kaugused>
BuilderFunctionTileDistanceMakePar=TileDistanceMakePar(<raster>, <kanal>, <barjäär>, <konf>) : <kaugused>
BuilderFunctionTileDistanceMakeSlope=TileDistanceMakeSlope(<raster>, <kanal>, <minKalle>, <maxKalle>, <minKaal>, <kaalTasapinnal>, <maxKaal>, <suund joonisele>) : <kaugused>
BuilderFunctionTileDistanceMakeSlopePar=TileDistanceMakeSlopePar(<raster>, <kanal>, <minKalle>, <maxKalle>, <minKaal>, <kaalTasapinnal>, <maxKaal>, <suund joonisele>, <konf>) : <kaugused>
BuilderFunctionTileDistanceMakeWeighted=TileDistanceMakeWeighted(<raster>, <kanal>, <võrdsed>) : <kaugused>
BuilderFunctionTileDistanceMakeWeightedPar=TileDistanceMakeWeightedPar(<raster>, <kanal>, <võrdsed>, <konf>) : <kaugused>
BuilderFunctionTileDistanceTilesClosest=TileDistanceTilesClosest(<kaugused>, <vektorjoonis>, <väljanimi>) : <tabel>
BuilderFunctionTileDistanceTilesClosestPar=TileDistanceTilesClosestPar(<kaugused>, <vektorjoonis>, <väljanimi>, <konf>) : <tabel>
BuilderFunctionTileDistanceTilesDirection=TileDistanceTilesDirection(<kaugused>, <vektorjoonis>, <tüüp>) : <tabel>
BuilderFunctionTileDistanceTilesDirectionPar=TileDistanceTilesDirectionPar(<kaugused>, <vektorjoonis>, <tüüp>, <konf>) : <tabel>
BuilderFunctionTileDistanceTilesLength=TileDistanceTilesLength(<kaugused>, <vektorjoonis>) : <tabel>
BuilderFunctionTileDistanceTilesLengthPar=TileDistanceTilesLengthPar(<kaugused>, <vektorjoonis>, <konf>) : <tabel>
BuilderFunctionTileErf=TileErf(<tail>) : <tail>
BuilderFunctionTileErfc=TileErfc(<tail>) : <tail>
BuilderFunctionTileExp=TileExp(<tail>) : <tail>
BuilderFunctionTileExp10=TileExp10(<tail>) : <tail>
BuilderFunctionTileExp2=TileExp2(<tail>) : <tail>
BuilderFunctionTileExpm1=TileExpm1(<tail>) : <tail>
BuilderFunctionTileFill=TileFill(<tail>, <arv/arvxN>) : <tail>
BuilderFunctionTileFillBaseLevel=TileFillBaseLevel(<raster>) : <tabel>
BuilderFunctionTileFillMissing=TileFillMissing(<tail>, <arv/arvxN>) : <tail>
BuilderFunctionTileFillMissingCopy=TileFillMissingCopy(<tail>, <tailBack>) : <tail>
BuilderFunctionTileFillMissingNearest=TileFillMissingNearest(<tail>, <raadius>) : <tail>
BuilderFunctionTileFillSinks=TileFillSinks(<raster>, <kanal>, <sügavusKuni>, <minVool>) : <tabel>
BuilderFunctionTileFillSinksPar=TileFillSinksPar(<raster>, <kanal>, <sügavusKuni>, <minVool>, <konf>) : <tabel>
BuilderFunctionTileFilter=TileFilter(<tail>, <raadius>, <filter>) : <tail>
BuilderFunctionTileFilterCount=TileFilterCount(<tail>, <raadius>, <filter>) : <tail>
BuilderFunctionTileFilterDefCircle=TileFilterDefCircle(<raadius>, <keskpunktiKaal>) : <tail>
BuilderFunctionTileFilterDefCross=TileFilterDefCross(<raadius>, <keskpunktiKaal>) : <tail>
BuilderFunctionTileFilterDefDiamond=TileFilterDefDiamond(<raadius>, <keskpunktiKaal>) : <tail>
BuilderFunctionTileFilterDefDirection=TileFilterDefDirection(<raadius>, <keskpunktiKaal>, <nurk>) : <tail>
BuilderFunctionTileFilterDefEdges=TileFilterDefEdges(<raadius>, <keskpunktiKaal>) : <tail>
BuilderFunctionTileFilterDefEdgesDirection=TileFilterDefEdgesDirection(<raadius>, <keskpunktiKaal>, <nurk>) : <tail>
BuilderFunctionTileFilterDefGaussian=TileFilterDefGaussian(<raadius>, <keskpunktiKaal>) : <tail>
BuilderFunctionTileFilterDefSharpen=TileFilterDefSharpen(<raadius>, <keskpunktiKaal>) : <tail>
BuilderFunctionTileFilterDefSquare=TileFilterDefSquare(<raadius>, <keskpunktiKaal>) : <tail>
BuilderFunctionTileFilterDiversity=TileFilterDiversity(<tail>, <raadius>, <filter>) : <tail>
BuilderFunctionTileFilterDiversityIndex=TileFilterDiversityIndex(<tail>, <raadius>, <filter>) : <tail>
BuilderFunctionTileFilterMajor=TileFilterMajor(<tail>, <raadius>, <filter>) : <tail>
BuilderFunctionTileFilterMax=TileFilterMax(<tail>, <raadius>, <filter>) : <tail>
BuilderFunctionTileFilterMedian=TileFilterMedian(<tail>, <raadius>, <filter>) : <tail>
BuilderFunctionTileFilterMin=TileFilterMin(<tail>, <raadius>, <filter>) : <tail>
BuilderFunctionTileFilterStDev=TileFilterStDev(<tail>, <raadius>, <filter>) : <tail>
BuilderFunctionTileFilterStDevPop=TileFilterStDevPop(<tail>, <raadius>, <filter>) : <tail>
BuilderFunctionTileFilterSum=TileFilterSum(<tail>, <raadius>, <filter>) : <tail>
BuilderFunctionTileFilterVar=TileFilterVar(<tail>, <raadius>, <filter>) : <tail>
BuilderFunctionTileFilterVarPop=TileFilterVarPop(<tail>, <raadius>, <filter>) : <tail>
BuilderFunctionTileFloor=TileFloor(<tail>) : <tail>
BuilderFunctionTileFloorDecs=TileFloorDecs(<tail>, <kümnendkohti>) : <tail>
BuilderFunctionTileFlowDirAccum=TileFlowDirAccum(<raster>, <kanal>) : <tabel>
BuilderFunctionTileFlowDirAccumPar=TileFlowDirAccumPar(<raster>, <kanal>, <konf>) : <tabel>
BuilderFunctionTileFract=TileFract(<tail>) : <tail>
BuilderFunctionTileFractDecs=TileFractDecs(<tail>, <kümnendkohti>) : <tail>
BuilderFunctionTileGeomAvg=TileGeomAvg(<raster>, <kanal>, <ruumikuju>) : <arv>
BuilderFunctionTileGeomCount=TileGeomCount(<raster>, <ruumikuju>) : <arv>
BuilderFunctionTileGeomDiversity=TileGeomDiversity(<raster>, <kanal>, <ruumikuju>) : <arv>
BuilderFunctionTileGeomDiversityIndex=TileGeomDiversityIndex(<raster>, <kanal>, <ruumikuju>) : <arv>
BuilderFunctionTileGeomMajor=TileGeomMajor(<raster>, <kanal>, <ruumikuju>) : <arv>
BuilderFunctionTileGeomMax=TileGeomMax(<raster>, <kanal>, <ruumikuju>) : <arv>
BuilderFunctionTileGeomMedian=TileGeomMedian(<raster>, <kanal>, <ruumikuju>) : <arv>
BuilderFunctionTileGeomMin=TileGeomMin(<raster>, <kanal>, <ruumikuju>) : <arv>
BuilderFunctionTileGeomOverlayCount=TileGeomOverlayCount(<raster>, <vektorjoonis>, <väljanimi>) : <tabel>
BuilderFunctionTileGeomOverlayCountPar=TileGeomOverlayCountPar(<raster>, <vektorjoonis>, <väljanimi>, <konf>) : <tabel>
BuilderFunctionTileGeomOverlayMax=TileGeomOverlayMax(<raster>, <vektorjoonis>, <väljanimi>) : <tabel>
BuilderFunctionTileGeomOverlayMaxPar=TileGeomOverlayMaxPar(<raster>, <vektorjoonis>, <väljanimi>, <konf>) : <tabel>
BuilderFunctionTileGeomOverlayMin=TileGeomOverlayMin(<raster>, <vektorjoonis>, <väljanimi>) : <tabel>
BuilderFunctionTileGeomOverlayMinPar=TileGeomOverlayMinPar(<raster>, <vektorjoonis>, <väljanimi>, <konf>) : <tabel>
BuilderFunctionTileGeomOverlaySum=TileGeomOverlaySum(<raster>, <vektorjoonis>, <väljanimi>) : <tabel>
BuilderFunctionTileGeomOverlaySumPar=TileGeomOverlaySumPar(<raster>, <vektorjoonis>, <väljanimi>, <konf>) : <tabel>
BuilderFunctionTileGeomSample=TileGeomSample(<raster>, <kanal>, <ruumikuju>) : <arv>
BuilderFunctionTileGeomStDev=TileGeomStDev(<raster>, <kanal>, <ruumikuju>) : <arv>
BuilderFunctionTileGeomStDevPop=TileGeomStDevPop(<raster>, <kanal>, <ruumikuju>) : <arv>
BuilderFunctionTileGeomSum=TileGeomSum(<raster>, <kanal>, <ruumikuju>) : <arv>
BuilderFunctionTileGeomToValues=TileGeomToValues(<raster>, <ruumikuju>) : <tabel>
BuilderFunctionTileGeomToValuesX2=TileGeomToValuesX2(<raster>, <ruumikuju>) : <tabel>
BuilderFunctionTileGeomToValuesX3=TileGeomToValuesX3(<raster>, <ruumikuju>) : <tabel>
BuilderFunctionTileGeomToValuesX4=TileGeomToValuesX4(<raster>, <ruumikuju>) : <tabel>
BuilderFunctionTileGeomVar=TileGeomVar(<raster>, <kanal>, <ruumikuju>) : <arv>
BuilderFunctionTileGeomVarPop=TileGeomVarPop(<raster>, <kanal>, <ruumikuju>) : <arv>
BuilderFunctionTileHcyBgr=TileHcyBgr(<tailhcy>) : <tailbgr>
BuilderFunctionTileHsiBgr=TileHsiBgr(<tailhsi>) : <tailbgr>
BuilderFunctionTileHslBgr=TileHslBgr(<tailhsl>) : <tailbgr>
BuilderFunctionTileHsvBgr=TileHsvBgr(<tailhsv>) : <tailbgr>
BuilderFunctionTileHypot=TileHypot(<x>, <y>) : <tail>
BuilderFunctionTileInterpolate=TileInterpolate(<interpolatsioon>, <kastx4>) : <tail>
BuilderFunctionTileInterpolateGravity=TileInterpolateGravity(<vektorjoonis>, <Zväljanimi>, <raadius>, <naabreid>, <järk>, <kastx4>, <mastaabitegurx2>) : <interpolatsioon>
BuilderFunctionTileInterpolateGravityPar=TileInterpolateGravityPar(<vektorjoonis>, <Zväljanimi>, <raadius>, <naabreid>, <järk>, <kastx4>, <mastaabitegurx2>, <konf>) : <interpolatsioon>
BuilderFunctionTileInterpolateKriging=TileInterpolateKriging(<vektorjoonis>, <Zväljanimi>, <raadius>, <naabreid>, <mudel>, <kastx4>, <mastaabitegurx2>) : <interpolatsioon>
BuilderFunctionTileInterpolateKrigingPar=TileInterpolateKrigingPar(<vektorjoonis>, <Zväljanimi>, <raadius>, <naabreid>, <mudel>, <kastx4>, <mastaabitegurx2>, <konf>) : <interpolatsioon>
BuilderFunctionTileInterpolateKrigingMedianPolish=TileInterpolateKrigingMedianPolish(<vektorjoonis>, <Zväljanimi>, <raadius>, <samm>, <naabreid>, <mudel>, <kastx4>, <mastaabitegurx2>) : <interpolatsioon>
BuilderFunctionTileInterpolateKrigingMedianPolishPar=TileInterpolateKrigingMedianPolishPar(<vektorjoonis>, <Zväljanimi>, <raadius>, <samm>, <naabreid>, <mudel>, <kastx4>, <mastaabitegurx2>, <konf>) : <interpolatsioon>
BuilderFunctionTileInterpolateKrigingRegression=TileInterpolateKrigingRegression(<vektorjoonis>, <Zväljanimi>, <raadius>, <samm>, <naabreid>, <mudel>, <regressioon>, <kastx4>, <mastaabitegurx2>) : <interpolatsioon>
BuilderFunctionTileInterpolateKrigingRegressionPar=TileInterpolateKrigingRegressionPar(<vektorjoonis>, <Zväljanimi>, <raadius>, <samm>, <naabreid>, <mudel>, <regressioon>, <kastx4>, <mastaabitegurx2>, <konf>) : <interpolatsioon>
BuilderFunctionTileInterpolateNatural=TileInterpolateNatural(<vektorjoonis>, <Zväljanimi>, <kastx4>, <mastaabitegurx2>) : <interpolatsioon>
BuilderFunctionTileInterpolateNaturalPar=TileInterpolateNaturalPar(<vektorjoonis>, <Zväljanimi>, <kastx4>, <mastaabitegurx2>, <konf>) : <interpolatsioon>
BuilderFunctionTileInterpolateReport=TileInterpolateReport(<interpolatsioon>) : <raport>
BuilderFunctionTileInterpolateSpline=TileInterpolateSpline(<vektorjoonis>, <Zväljanimi>, <raadius>, <naabreid>, <kastx4>, <mastaabitegurx2>) : <interpolatsioon>
BuilderFunctionTileInterpolateSplinePar=TileInterpolateSplinePar(<vektorjoonis>, <Zväljanimi>, <raadius>, <naabreid>, <kastx4>, <mastaabitegurx2>, <konf>) : <interpolatsioon>
BuilderFunctionTileInterpolateTriangulation=TileInterpolateTriangulation(<vektorjoonis>, <Zväljanimi>, <kastx4>, <mastaabitegurx2>) : <interpolatsioon>
BuilderFunctionTileInterpolateTriangulationPar=TileInterpolateTriangulationPar(<vektorjoonis>, <Zväljanimi>, <kastx4>, <mastaabitegurx2>, <konf>) : <interpolatsioon>
BuilderFunctionTileInterpolateTriangulationSeg=TileInterpolateTriangulationSeg(<vektorjoonis>, <Zväljanimi>, <DEST?>, <kastx4>, <mastaabitegurx2>) : <interpolatsioon>
BuilderFunctionTileInterpolateTriangulationSegPar=TileInterpolateTriangulationSegPar(<vektorjoonis>, <Zväljanimi>, <DEST?>, <kastx4>, <mastaabitegurx2>, <konf>) : <interpolatsioon>
BuilderFunctionTileJ0=TileJ0(<tail>) : <tail>
BuilderFunctionTileJ1=TileJ1(<tail>) : <tail>
BuilderFunctionTileJn=TileJn(<järk>, <tail>) : <tail>
BuilderFunctionTileJson=TileJson(<tail>) : <json>
BuilderFunctionTileLgamma=TileLgamma(<tail>) : <tail>
BuilderFunctionTileLog=TileLog(<tail>) : <tail>
BuilderFunctionTileLog10=TileLog10(<tail>) : <tail>
BuilderFunctionTileLog1p=TileLog1p(<tail>) : <tail>
BuilderFunctionTileLog2=TileLog2(<tail>) : <tail>
BuilderFunctionTileMake=TileMake(<cx>, <cy>, <arv/arvxN>) : <tail>
BuilderFunctionTileMask=TileMask(<tail>) : <mask>
BuilderFunctionTileMaskRange=TileMaskRange(<tail>, <alates>, <kuni>, <alatesKuniKaasaArvatud?>, <säilitaVahemik>) : <tail>
BuilderFunctionTileMaskReplace=TileMaskReplace(<tail>, <mask>) : <tail>
BuilderFunctionTileMax=TileMax(<p>, <q>) : <tail>
BuilderFunctionTileMin=TileMin(<p>, <q>) : <tail>
BuilderFunctionTileNoise=TileNoise(<tail>, <vahemik>) : <tail>
BuilderFunctionTilePow=TilePow(<tail>, <astendaja>) : <tail>
BuilderFunctionTileRcbrt=TileRcbrt(<tail>) : <tail>
BuilderFunctionTileRemoveBorder=TileRemoveBorder(<tail>, <äärelaius>) : <tail>
BuilderFunctionTileRender=TileRender(<komponendiNimi>, <kastx4>, <pildimõõdudx2>, <tailimõõdudx2>, <dpi>, <virtuaalkihtidega>) : <tabel>
BuilderFunctionTileRenderSingle=TileRenderSingle(<komponendiNimi>, <kastx4>, <pildimõõdudx2>, <dpi>, <virtuaalkihtidega>) : <tail>
BuilderFunctionTileRenderSingleWindow=TileRenderSingleWindow(<aknaNimi>, <kastx4>, <pildimõõdudx2>, <dpi>, <virtuaalkihtidega>) : <tail>
BuilderFunctionTileRenderWindow=TileRenderWindow(<aknaNimi>, <kastx4>, <pildimõõdudx2>, <tailimõõdudx2>, <dpi>, <virtuaalkihtidega>) : <tabel>
BuilderFunctionTileRound=TileRound(<tail>) : <tail>
BuilderFunctionTileRoundDecs=TileRoundDecs(<tail>, <kümnendkohti>) : <tail>
BuilderFunctionTileRsqrt=TileRsqrt(<tail>) : <tail>
BuilderFunctionTileSieve=TileSieve(<raster>, <kanal>, <sarnasus>, <minPindala>, <mestimisviis>) : <tabel>
BuilderFunctionTileSievePar=TileSievePar(<raster>, <kanal>, <sarnasus>, <minPindala>, <mestimisviis>, <konf>) : <tabel>
BuilderFunctionTileSieveStep=TileSieveStep(<raster>, <kanal>, <sarnasus>, <minPindala>, <mestimisviis>) : <tabel>
BuilderFunctionTileSieveStepPar=TileSieveStepPar(<raster>, <kanal>, <sarnasus>, <minPindala>, <mestimisviis>, <konf>) : <tabel>
BuilderFunctionTileSign=TileSign(<tail>) : <tail>
BuilderFunctionTileSin=TileSin(<tail>) : <tail>
BuilderFunctionTileSinh=TileSinh(<tail>) : <tail>
BuilderFunctionTileSize=TileSize(<tail>) : <tailimõõdudx2>
BuilderFunctionTileSlope=TileSlope(<tail>, <raadius>, <mastaabitegurx3>) : <tail>
BuilderFunctionTileSqrt=TileSqrt(<tail>) : <tail>
BuilderFunctionTileTan=TileTan(<tail>) : <tail>
BuilderFunctionTileTanh=TileTanh(<tail>) : <tail>
BuilderFunctionTileTgamma=TileTgamma(<tail>) : <tail>
BuilderFunctionTileToValues=TileToValues(<tail>, <puuduvad?>) : <tabel>
BuilderFunctionTileToValuesX2=TileToValuesX2(<tail>, <puuduvad?>) : <tabel>
BuilderFunctionTileToValuesX3=TileToValuesX3(<tail>, <puuduvad?>) : <tabel>
BuilderFunctionTileToValuesX4=TileToValuesX4(<tail>, <puuduvad?>) : <tabel>
BuilderFunctionTileTraceArea=TileTraceArea(<raster>, <arv/arvxN>, <sarnasus>) : <ruumikuju>
BuilderFunctionTileTraceAreaPar=TileTraceAreaPar(<raster>, <arv/arvxN>, <sarnasus>, <konf>) : <ruumikuju>
BuilderFunctionTileTraceAreas=TileTraceAreas(<raster>, <sarnasus>, <lõhu?>) : <tabel>
BuilderFunctionTileTraceAreasPar=TileTraceAreasPar(<raster>, <sarnasus>, <lõhu?>, <konf>) : <tabel>
BuilderFunctionTileTraceAreasX2=TileTraceAreasX2(<raster>, <sarnasus>, <lõhu?>) : <tabel>
BuilderFunctionTileTraceAreasX2Par=TileTraceAreasX2Par(<raster>, <sarnasus>, <lõhu?>, <konf>) : <tabel>
BuilderFunctionTileTraceAreasX3=TileTraceAreasX3(<raster>, <sarnasus>, <lõhu?>) : <tabel>
BuilderFunctionTileTraceAreasX3Par=TileTraceAreasX3Par(<raster>, <sarnasus>, <lõhu?>, <konf>) : <tabel>
BuilderFunctionTileTraceAreasX4=TileTraceAreasX4(<raster>, <sarnasus>, <lõhu?>) : <tabel>
BuilderFunctionTileTraceAreasX4Par=TileTraceAreasX4Par(<raster>, <sarnasus>, <lõhu?>, <konf>) : <tabel>
BuilderFunctionTileTrunc=TileTrunc(<tail>) : <tail>
BuilderFunctionTileTruncDecs=TileTruncDecs(<tail>, <kümnendkohti>) : <tail>
BuilderFunctionTileUpdateFieldPyramids=TileUpdateFieldPyramids(<komponent>, <väljanimi>) : <tabel>
BuilderFunctionTileUpdatePyramids=TileUpdatePyramids(<raster>) : <tabel>
BuilderFunctionTileUpdatePyramidsAll=TileUpdatePyramidsAll(<komponent>) : <tabel>
BuilderFunctionTileValueAvg=TileValueAvg(<tail>) : <arv>
BuilderFunctionTileValueCount=TileValueCount(<tail>) : <arv>
BuilderFunctionTileValueCountMissing=TileValueCountMissing(<tail>) : <arv>
BuilderFunctionTileValueMax=TileValueMax(<tail>) : <arv>
BuilderFunctionTileValueMin=TileValueMin(<tail>) : <arv>
BuilderFunctionTileValueStDev=TileValueStDev(<tail>) : <arv>
BuilderFunctionTileValueStDevPop=TileValueStDevPop(<tail>) : <arv>
BuilderFunctionTileValueSum=TileValueSum(<tail>) : <arv>
BuilderFunctionTileValueVar=TileValueVar(<tail>) : <arv>
BuilderFunctionTileValueVarPop=TileValueVarPop(<tail>) : <arv>
BuilderFunctionTileViewshedArea=TileViewshedArea(<vaateväli>, <vaatlejax2>, <suhtelineZ>, <maxRaadius>, <minNurk>, <maxNurk>) : <ruumikuju>
BuilderFunctionTileViewshedAreaAll=TileViewshedAreaAll(<vaateväli>, <vektorjoonis>, <ZväljaNimi>, <suhtelineZ>, <maxRaadius>, <minNurk>, <maxNurk>) : <ruumikuju>
BuilderFunctionTileViewshedAreaAllPar=TileViewshedAreaAllPar(<vaateväli>, <vektorjoonis>, <ZväljaNimi>, <suhtelineZ>, <maxRaadius>, <minNurk>, <maxNurk>, <konf>) : <ruumikuju>
BuilderFunctionTileViewshedAreaAny=TileViewshedAreaAny(<vaateväli>, <vektorjoonis>, <ZväljaNimi>, <suhtelineZ>, <maxRaadius>, <minNurk>, <maxNurk>) : <ruumikuju>
BuilderFunctionTileViewshedAreaAnyPar=TileViewshedAreaAnyPar(<vaateväli>, <vektorjoonis>, <ZväljaNimi>, <suhtelineZ>, <maxRaadius>, <minNurk>, <maxNurk>, <konf>) : <ruumikuju>
BuilderFunctionTileViewshedAreaPar=TileViewshedAreaPar(<vaateväli>, <vaatlejax3>, <suhtelineZ>, <maxRaadius>, <minNurk>, <maxNurk>, <konf>) : <ruumikuju>
BuilderFunctionTileViewshedMake=TileViewshedMake(<raster>, <kanal>, <refrakstioonitegur>, <kasutaEllipsoidi>) : <vaateväli>
BuilderFunctionTileViewshedMakePar=TileViewshedMakePar(<raster>, <kanal>, <refrakstioonitegur>, <kasutaEllipsoidi>, <konf>) : <vaateväli>
BuilderFunctionTileViewshedTilesCount=TileViewshedTilesCount(<vaateväli>, <vektorjoonis>, <ZväljaNimi>, <suhtelineZ>, <maxRaadius>, <minNurk>, <maxNurk>) : <tabel>
BuilderFunctionTileViewshedTilesCountPar=TileViewshedTilesCountPar(<vaateväli>, <vektorjoonis>, <ZväljaNimi>, <suhtelineZ>, <maxRaadius>, <minNurk>, <maxNurk>, <konf>) : <tabel>
BuilderFunctionTileViewshedTilesLevelAll=TileViewshedTilesLevelAll(<vaateväli>, <vektorjoonis>, <ZväljaNimi>, <suhtelineZ>, <maxRaadius>, <minNurk>, <maxNurk>) : <tabel>
BuilderFunctionTileViewshedTilesLevelAllPar=TileViewshedTilesLevelAllPar(<vaateväli>, <vektorjoonis>, <ZväljaNimi>, <suhtelineZ>, <maxRaadius>, <minNurk>, <maxNurk>, <konf>) : <tabel>
BuilderFunctionTileViewshedTilesLevelAny=TileViewshedTilesLevelAny(<vaateväli>, <vektorjoonis>, <ZväljaNimi>, <suhtelineZ>, <maxRaadius>, <minNurk>, <maxNurk>) : <tabel>
BuilderFunctionTileViewshedTilesLevelAnyPar=TileViewshedTilesLevelAnyPar(<vaateväli>, <vektorjoonis>, <ZväljaNimi>, <suhtelineZ>, <maxRaadius>, <minNurk>, <maxNurk>, <konf>) : <tabel>
BuilderFunctionTileViewshedTraceLine=TileViewshedTraceLine(<vaateväli>, <vaatlejax3>, <asukohtx3>, <suhtelineZ>, <minNurk>, <maxNurk>) : <kõrgus>
BuilderFunctionTileWatershedAreas=TileWatershedAreas(<valgalad>, <minVool>) : <tabel>
BuilderFunctionTileWatershedAreasPar=TileWatershedAreasPar(<valgalad>, <minVool>, <konf>) : <tabel>
BuilderFunctionTileWatershedAreasSinks=TileWatershedAreasSinks(<valgalad>, <säilitaVäljuvad>) : <tabel>
BuilderFunctionTileWatershedAreasSinksPar=TileWatershedAreasSinksPar(<valgalad>, <säilitaVäljuvad>, <konf>) : <tabel>
BuilderFunctionTileWatershedAreasUpstream=TileWatershedAreasUpstream(<valgalad>, <vektorjoonis>, <säilitaKattuvad>) : <tabel>
BuilderFunctionTileWatershedAreasUpstreamPar=TileWatershedAreasUpstreamPar(<valgalad>, <vektorjoonis>, <säilitaKattuvad>, <konf>) : <tabel>
BuilderFunctionTileWatershedAreaUpstream=TileWatershedAreaUpstream(<valgalad>, <koordx2>) : <ruumikuju>
BuilderFunctionTileWatershedAreaUpstreamPar=TileWatershedAreaUpstreamPar(<valgalad>, <koordx2>, <konf>) : <ruumikuju>
BuilderFunctionTileWatershedLines=TileWatershedLines(<valgalad>, <minVool>) : <tabel>
BuilderFunctionTileWatershedLinesPar=TileWatershedLinesPar(<valgalad>, <minVool>, <konf>) : <tabel>
BuilderFunctionTileWatershedLinesDownstream=TileWatershedLinesDownstream(<valgalad>, <vektorjoonis>, <säilitaKattuvad>) : <tabel>
BuilderFunctionTileWatershedLinesDownstreamPar=TileWatershedLinesDownstreamPar(<valgalad>, <vektorjoonis>, <säilitaKattuvad>, <konf>) : <tabel>
BuilderFunctionTileWatershedLinesUpstream=TileWatershedLinesUpstream(<valgalad>, <vektorjoonis>, <minVool>, <säilitaKattuvad>) : <tabel>
BuilderFunctionTileWatershedLinesUpstreamPar=TileWatershedLinesUpstreamPar(<valgalad>, <vektorjoonis>, <minVool>, <säilitaKattuvad>, <konf>) : <tabel>
BuilderFunctionTileWatershedLineDownstream=TileWatershedLineDownstream(<valgalad>, <koordx2>) : <ruumikuju>
BuilderFunctionTileWatershedLineDownstreamPar=TileWatershedLineDownstreamPar(<valgalad>, <koordx2>, <konf>) : <ruumikuju>
BuilderFunctionTileWatershedLineUpstream=TileWatershedLineUpstream(<valgalad>, <koordx2>, <minVool>) : <ruumikuju>
BuilderFunctionTileWatershedLineUpstreamPar=TileWatershedLineUpstreamPar(<valgalad>, <koordx2>, <minVool>, <konf>) : <ruumikuju>
BuilderFunctionTileWatershedMake=TileWatershedMake(<raster>, <kanal>, <kaaluKanal>) : <valgalad>
BuilderFunctionTileWatershedMakePar=TileWatershedMakePar(<raster>, <kanal>, <kaaluKanal>, <konf>) : <valgalad>
BuilderFunctionTileWatershedMakeDir=TileWatershedMakeDir(<rasterSuund>, <kanal>, <kaaluKanal>) : <valgalad>
BuilderFunctionTileWatershedMakeDirPar=TileWatershedMakeDirPar(<rasterSuund>, <kanal>, <kaaluKanal>, <konf>) : <valgalad>
BuilderFunctionTileY0=TileY0(<tail>) : <tail>
BuilderFunctionTileY1=TileY1(<tail>) : <tail>
BuilderFunctionTileYn=TileYn(<järk>, <tail>) : <tail>
BuilderFunctionTrunc=Trunc(<arv>) : <arv>
BuilderFunctionTruncDecs=TruncDecs(<arv>, <kümnendkohti>) : <arv>
BuilderFunctionTypeName=TypeName(<väärtus>) : <nimi>
BuilderFunctionUuidMakeNew=UuidMakeNew() : <uuid>
BuilderFunctionUuidMakeNewRef=UuidMakeNewRef(<sõltuvus>) : <uuid>
BuilderFunctionValueCount=ValueCount(<tabel>) : <arv>
BuilderFunctionValueSequence=ValueSequence(<alates>, <kuni>, <samm>) : <tabel>
BuilderFunctionValueSequenceRandom=ValueSequenceRandom(<arv>, <seeme>) : <tabel>
BuilderFunctionValueSequenceRandomInt=ValueSequenceRandomInt(<arv>, <limiit>, <seeme>) : <tabel>
BuilderFunctionValueSequenceTileXY=ValueSequenceTileXY(<kastx4>, <tailimõõdudx2>, <ülenisees>) : <tabel>
BuilderFunctionVar=Var(<arv>) : <arv>
BuilderFunctionVarPop=VarPop(<arv>) : <arv>
BuilderFunctionVectorBgrHcy=VectorBgrHcy(<bgr>) : <hcy>
BuilderFunctionVectorBgrHsi=VectorBgrHsi(<bgr>) : <hsi>
BuilderFunctionVectorBgrHsl=VectorBgrHsl(<bgr>) : <hsl>
BuilderFunctionVectorBgrHsv=VectorBgrHsv(<bgr>) : <hsv>
BuilderFunctionVectorCross=VectorCross(<arvx3>, <arvx3>) : <arvx3>
BuilderFunctionVectorDot=VectorDot(<arvxN>, <arvxN>) : <arv>
BuilderFunctionVectorHcyBgr=VectorHcyBgr(<hcy>) : <bgr>
BuilderFunctionVectorHsiBgr=VectorHsiBgr(<hsi>) : <bgr>
BuilderFunctionVectorHslBgr=VectorHslBgr(<hsl>) : <bgr>
BuilderFunctionVectorHsvBgr=VectorHsvBgr(<hsv>) : <bgr>
BuilderFunctionVectorMakeX2=VectorMakeX2(<arv>, <arv>) : <arvx2>
BuilderFunctionVectorMakeX3=VectorMakeX3(<arv>, <arv>, <arv>) : <arvx3>
BuilderFunctionVectorMakeX4=VectorMakeX4(<arv>, <arv>, <arv>, <arv>) : <arvx4>
BuilderFunctionVectorValue=VectorValue(<arvxN>, <indeks>) : <arv>
BuilderFunctionVectorValues=VectorValues(<arvxN>, <arvxN>) : <arvxN>
BuilderFunctionY0=Y0(<arv>) : <arv>
BuilderFunctionY1=Y1(<arv>) : <arv>
BuilderFunctionYn=Yn(<järk>, <arv>) : <arv>
BuilderOperator=Tehted
BuilderOperatorAdd=<arv> + <arv>
BuilderOperatorAddString=<sõne> & <sõne>
BuilderOperatorAnd=<tõeväärtus> AND <tõeväärtus>
BuilderOperatorBetween=<väärtus> BETWEEN <väärtus> AND <väärtus>
BuilderOperatorBitAnd=<väärtus> BITAND <väärtus>
BuilderOperatorBitNot=BITNOT <väärtus>
BuilderOperatorBitOr=<väärtus> BITOR <väärtus>
BuilderOperatorBitXor=<väärtus> BITXOR <väärtus>
BuilderOperatorCase=CASE WHEN <tingimus> THEN <väärtus> ... ELSE <väärtus> END
BuilderOperatorCaseDirect=CASE <väärtus> WHEN <väärtus> THEN <väärtus> ... ELSE <väärtus> END
BuilderOperatorCast=CAST (<väärtus> AS <tüüp>)
BuilderOperatorCastValues=CASTV (<väärtus> AS <tüüp>)
BuilderOperatorDivide=<arv> / <arv>
BuilderOperatorDivideTrunc=<arv> DIV <arv>
BuilderOperatorEquals=<väärtus> = <väärtus>
BuilderOperatorExists=EXISTS <tabel>
BuilderOperatorFunction=<funktsioon>(...)
BuilderOperatorFunctionCall=CALL <tabelifunktsioon>(...)
BuilderOperatorFunctionInline=INLINE <agregaator-funktsioon>(...)
BuilderOperatorGreater=<väärtus> > <väärtus>
BuilderOperatorGreaterEquals=<väärtus> >= <väärtus>
BuilderOperatorIn=<väärtus> IN (<tabel>)
BuilderOperatorInDirect=<väärtus> IN (<väärtus>, ...)
BuilderOperatorIsNull=<väärtus> IS NULL
BuilderOperatorLess=<väärtus> < <väärtus>
BuilderOperatorLessEquals=<väärtus> <= <väärtus>
BuilderOperatorLike=<väärtus> LIKE <väärtus>
BuilderOperatorModulo=<arv> MOD <arv>
BuilderOperatorModuloShort=<arv> % <arv>
BuilderOperatorMultiply=<arv> * <arv>
BuilderOperatorNegate=- <arv>
BuilderOperatorNot=NOT <tõeväärtus>
BuilderOperatorNotEquals=<väärtus> <> <väärtus>
BuilderOperatorOr=<tõeväärtus> OR <tõeväärtus>
BuilderOperatorPower=<väärtus> ^ <väärtus>
BuilderOperatorSubtract=<väärtus> - <väärtus>
BuilderOperatorTuple=Tuple operators
BuilderOperatorTupleBetween=(<väärtus>, ...) BETWEEN (<väärtus>, ...) AND (<väärtus>, ...)
BuilderOperatorTupleEquals=(<väärtus>, ...) = (<väärtus>, ...)
BuilderOperatorTupleGreater=(<väärtus>, ...) > (<väärtus>, ...)
BuilderOperatorTupleGreaterEquals=(<väärtus>, ...) >= (<väärtus>, ...)
BuilderOperatorTupleIn=(<väärtus>, ...) IN (<tabel>)
BuilderOperatorTupleLess=(<väärtus>, ...) < (<väärtus>, ...)
BuilderOperatorTupleLessEquals=(<väärtus>, ...) <= (<väärtus>, ...)
BuilderOperatorTupleNotEquals=(<väärtus>, ...) <> (<väärtus>, ...)
BuilderOperatorXor=<tõeväärtus> XOR <tõeväärtus>
BuilderPragma=Pragmad
BuilderPragmaCreatedName='createdname' : määratud CREATE poolt
BuilderPragmaCreatedNameQuoted='creatednamequoted' : määratud CREATE poolt
BuilderPragmaGpgpu='gpgpu' = 'auto' / 'none' / 'aggressive'
BuilderPragmaGpgpuDevice='gpgpu.device' = '<indeks>'
BuilderPragmaGpgpuFp='gpgpu.fp' = '32' / '64'
BuilderPragmaProgress='progress' = '<sõnum>'
BuilderPragmaProgressPercent='progress.percent' = '<protsent>'
BuilderPragmaProgressPercentInsertSource='progress.percentinsertsource' = '<protsent-lisamisel>'
BuilderPragmaProgressPercentNext='progress.percentnext' = '<protsent-pärast-järgmist-käsku>'
BuilderPreprocessor=Preprotsessori direktiivid
BuilderPreprocessorInclude=-- $include$ <päring>
BuilderPreprocessorManifold=-- $manifold$
BuilderQuery=Laused
BuilderQueryAlterAny=ALTER <komponendi tüüp> <komponent> (<toiming>, ...)
BuilderQueryAlterTable=ALTER TABLE <tabel> (<toiming>, ...)
BuilderQueryCreateAny=CREATE <komponendi tüüp> <komponent> (<üksus>, ...)
BuilderQueryCreateRoot=CREATE ROOT <juurläte>
BuilderQueryCreateRootLink=CREATE DATASOURCE <komponent> AS ROOT
BuilderQueryCreateTable=CREATE TABLE <tabel> (<üksus>, ...)
BuilderQueryDelete=DELETE FROM <tabel>
BuilderQueryDropAny=DROP <komponendi tüüp> <komponent>
BuilderQueryDropRoot=DROP ROOT <juurläte>
BuilderQueryDropTable=DROP TABLE <tabel>
BuilderQueryExecute=EXECUTE WITH (@<parameeter> <tüüp> = <avaldis>, ...) <päring>
BuilderQueryExecuteForeign=EXECUTE WITH (@<parameeter> <tüüp> = <avaldis>, ...) [[ <päring> ]]
BuilderQueryFragmentAddConstraint=ADD CONSTRAINT <kitsendus> WITH [[ <kontekst> ]] AS [[ <tingimus> ]]
BuilderQueryFragmentAddField=ADD <väli> <tüüp>
BuilderQueryFragmentAddFieldComputed=ADD <väli> <tüüp> WITH [[ <kontekst> ]] AS [[ <avaldis> ]]
BuilderQueryFragmentAddIndex=ADD INDEX <indeks> <indeksitüüp> (<väli> <suvandid>, ...)
BuilderQueryFragmentAddProperty=ADD PROPERTY <atribuut> <sõne>
BuilderQueryFragmentAll=ALL
BuilderQueryFragmentAs=AS (<väli>, ...)
BuilderQueryFragmentAsc=ASC / DESC
BuilderQueryFragmentBatch=BATCH <arv>
BuilderQueryFragmentCollate=COLLATE '<sorteerimisalus>'
BuilderQueryFragmentCollect=COLLECT <väli>, ...
BuilderQueryFragmentConstraint=CONSTRAINT <kitsendus> WITH [[ <kontekst> ]] AS [[ <tingimus> ]]
BuilderQueryFragmentDistinct=DISTINCT
BuilderQueryFragmentDropConstraint=DROP CONSTRAINT <kitsendus>
BuilderQueryFragmentDropField=DROP <väli>
BuilderQueryFragmentDropIndex=DROP INDEX <indeks>
BuilderQueryFragmentDropProperty=DROP PROPERTY <atribuut>
BuilderQueryFragmentEntry=ENTRY '<klass>.<meetod>'
BuilderQueryFragmentEntrySchema=ENTRYSCHEMA '<klass>.<meetod>'
BuilderQueryFragmentFetch=FETCH <väärtus>
BuilderQueryFragmentField=<väli> <tüüp>
BuilderQueryFragmentFieldComputed=<väli> <tüüp> WITH [[ <kontekst> ]] AS [[ <avaldis> ]]
BuilderQueryFragmentGroup=GROUP BY <väli>, ...
BuilderQueryFragmentHaving=HAVING <tingimus>
BuilderQueryFragmentIndexBtree=INDEX <indeks> BTREE (<väli> <suvandid>, ...)
BuilderQueryFragmentIndexBtreeDup=INDEX <indeks> BTREEDUP (<väli> <suvandid>, ...)
BuilderQueryFragmentIndexBtreeDupNull=INDEX <indeks> BTREEDUPNULL (<väli> <suvandid>, ...)
BuilderQueryFragmentIndexBtreeNull=INDEX <indeks> BTREENULL (<väli> <suvandid>, ...)
BuilderQueryFragmentIndexRtree=INDEX <indeks> RTREE (<väli>)
BuilderQueryFragmentIndexRtreeTile=INDEX <indeks> RTREE (<väliX>, <väliY>, <tailiväli> TILESIZE (<cx>, <cy>) TILETYPE <tüüp> ...)
BuilderQueryFragmentInto=INTO <uus tabel>
BuilderQueryFragmentIntoSchema=INTO <uus tabel> (<üksus>, ...)
BuilderQueryFragmentJoinCross=<tabel> CROSS JOIN <tabel>
BuilderQueryFragmentJoinInner=<tabel> INNER JOIN <tabel> ON <tingimus>
BuilderQueryFragmentJoinOuter=<tabel> LEFT / RIGHT / FULL OUTER JOIN <tabel> ON <tingimus>
BuilderQueryFragmentOffset=OFFSET <arv>
BuilderQueryFragmentOn=ON <andmeläte>
BuilderQueryFragmentOrder=ORDER BY <väli> <suvandid>, ...
BuilderQueryFragmentProperty=PROPERTY <atribuut> <sõne>
BuilderQueryFragmentRenameConstraint=RENAME CONSTRAINT <kitsendus> <uus nimi>
BuilderQueryFragmentRenameField=RENAME <väli> <uus nimi>
BuilderQueryFragmentRenameIndex=RENAME INDEX <indeks> <uus nimi>
BuilderQueryFragmentSplit=SPLIT <tabel>
BuilderQueryFragmentThreads=THREADS <arv>
BuilderQueryFragmentTileReduce=TILEREDUCE 'AVERAGE' / 'INDEXED'
BuilderQueryFragmentUnion=UNION / EXCEPT / INTERSECT <tabel>
BuilderQueryFragmentWhere=WHERE <tingimus>
BuilderQueryFunction=FUNCTION <nimi>(@<parameeter> <tüüp>, ...) <tüüp> AS <avaldis> END
BuilderQueryFunctionScript=FUNCTION <nimi>(@<parameeter> <tüüp>, ...) <tüüp> AS SCRIPT <skript>
BuilderQueryFunctionScriptFile=FUNCTION <nimi>(@<parameeter> <tüüp>, ...) <tüüp> AS SCRIPT FILE '<fail>'
BuilderQueryFunctionScriptInline=FUNCTION <nimi>(@<parameeter> <tüüp>, ...) <tüüp> AS SCRIPT INLINE <skript>
BuilderQueryInsert=INSERT INTO <tabel> <väljad>
BuilderQueryPragma=PRAGMA ('<pragma>' = '<sõne>', ...)
BuilderQueryPragmaPop=PRAGMA POP
BuilderQueryPragmaPush=PRAGMA PUSH
BuilderQueryRenameAny=RENAME <komponendi tüüp> <komponent> <uus nimi>
BuilderQueryRenameTable=RENAME TABLE <tabel> <uus nimi>
BuilderQueryScript=SCRIPT <skript> ENGINE '<skriptimootor>' [[ <tekst> ]]
BuilderQuerySelect=SELECT <väli>, ... FROM <tabel>
BuilderQueryTable=TABLE <tabel> / CALL <tabelifunktsioon>
BuilderQueryUpdate=UPDATE <tabel> SET <väli> = <avaldis>, ...
BuilderQueryUse=USE CHILD <alam>
BuilderQueryUseParent=USE PARENT
BuilderQueryUseRoot=USE ROOT <juurläte>
BuilderQueryValue=VALUE @<muutuja> <tüüp>
BuilderQueryValueSet=VALUE @<muutuja> <tüüp> = <avaldis>
BuilderQueryValues=VALUES (<väärtus>, ...), ...
BuilderThread=Lõimede seadistamine
BuilderThreadBatch="batch": <kirjete arv>
BuilderThreadThreads="threads": <lõimede arv>
BuilderType=Tüübid
BuilderTypeBinaryVar=VARBINARY
BuilderTypeBoolean=BOOLEAN
BuilderTypeCharVar=VARCHAR
BuilderTypeCharVarN=NVARCHAR
BuilderTypeDateTime=DATETIME
BuilderTypeFloat32=FLOAT32
BuilderTypeFloat32x2=FLOAT32X2
BuilderTypeFloat32x3=FLOAT32X3
BuilderTypeFloat32x4=FLOAT32X4
BuilderTypeFloat64=FLOAT64
BuilderTypeFloat64x2=FLOAT64X2
BuilderTypeFloat64x3=FLOAT64X3
BuilderTypeFloat64x4=FLOAT64X4
BuilderTypeGeom=GEOM
BuilderTypeGeomMfd=GEOMMFD
BuilderTypeGeomWkb=GEOMWKB
BuilderTypeInt8=INT8
BuilderTypeInt8x2=INT8X2
BuilderTypeInt8x3=INT8X3
BuilderTypeInt8x4=INT8X4
BuilderTypeInt8U=UINT8
BuilderTypeInt8Ux2=UINT8X2
BuilderTypeInt8Ux3=UINT8X3
BuilderTypeInt8Ux4=UINT8X4
BuilderTypeInt16=INT16
BuilderTypeInt16x2=INT16X2
BuilderTypeInt16x3=INT16X3
BuilderTypeInt16x4=INT16X4
BuilderTypeInt16U=UINT16
BuilderTypeInt16Ux2=UINT16X2
BuilderTypeInt16Ux3=UINT16X3
BuilderTypeInt16Ux4=UINT16X4
BuilderTypeInt32=INT32
BuilderTypeInt32x2=INT32X2
BuilderTypeInt32x3=INT32X3
BuilderTypeInt32x4=INT32X4
BuilderTypeInt32U=UINT32
BuilderTypeInt32Ux2=UINT32X2
BuilderTypeInt32Ux3=UINT32X3
BuilderTypeInt32Ux4=UINT32X4
BuilderTypeInt64=INT64
BuilderTypeInt64x2=INT64X2
BuilderTypeInt64x3=INT64X3
BuilderTypeInt64x4=INT64X4
BuilderTypeInt64U=UINT64
BuilderTypeInt64Ux2=UINT64X2
BuilderTypeInt64Ux3=UINT64X3
BuilderTypeInt64Ux4=UINT64X4
BuilderTypeTile=TILE
BuilderTypeUuid=UUID
BuilderTypeX2=Vektortüübid (x2)
BuilderTypeX3=Vektortüübid (x3)
BuilderTypeX4=Vektortüübid (x4)

# <name>|<description>
CommandEdit=Redigeeri|Edit commands.
CommandEditAdvanced=Täpsem|Advanced edit commands.
CommandEditCollateFavorites=Lemmikute muutmine...|Edit list of favorite collations.
CommandEditCollateSelect=Muuda sortimisreeglit...|Edit collation.
CommandEditCoordBaseCopy=Kopeeri|Copy base coordinate system to the clipboard.
CommandEditCoordBaseFavorites=Lemmikute muutmine...|Edit list of favorite base coordinate systems.
CommandEditCoordBasePaste=Kleebi|Paste base coordinate system from the clipboard.
CommandEditCoordBaseSelect=Muuda daatumit...|Edit base coordinate system.
CommandEditCoordLocals=Muuda ühikuid...|Edit offsets, scales and units used by coordinate system.
CommandEditCoordLocalsSystem=Kasuta vaikimisi ühikuid|Set offsets, scales and units used by coordinate system to default values.
CommandEditCoordParamBrowse=Sirvi...|Browse for file.
CommandEditCoordParamConvert=Ühikute teisendamine...|Edit parameter value using unit converter.
CommandEditCoordParamDefault=Kasuta vaikeväärtust|Set parameter to default value.
CommandEditCoordSystem=Teisenda projektsioon...|Project component to another coordinate system.
CommandEditCoordSystemCopy=Kopeeri|Copy coordinate system to the clipboard.
CommandEditCoordSystemFavorites=Lemmikute muutmine...|Edit list of favorite coordinate systems.
CommandEditCoordSystemForceXY=Rakenda XY-teljestik|Adjust coordinate system to use XY axes order.
CommandEditCoordSystemPaste=Kleebi|Paste coordinate system from the clipboard.
CommandEditCoordSystemPastePlain=Kleebi ühikuteta|Paste coordinate system from the clipboard, keep existing offsets, scales and units.
CommandEditCoordSystemSelect=Vali projektsioon...|Edit coordinate system.
CommandEditCoordSystemSet=Määra algne projektsioon|Specify initial component coordinate system.
CommandEditCoordSystemSetOverride=Määra uuesti (paranda) projektsioon|Repair initial component coordinate system.
CommandEditCopy=Kopeeri|Copy selected data to the clipboard.
CommandEditCut=Lõika|Cut selected data and move it to the clipboard.
CommandEditDelete=Kustuta|Delete selected data.
CommandEditErrorNext=Leia järgmine viga|Go to next error.
CommandEditErrorPrevious=Leia eelmine viga|Go to previous error.
CommandEditExportResults=Ekspordi tulemused...|Export results for use in other applications.
CommandEditExportSelected=Ekspordi valitud...|Export selected records for use in other applications.
CommandEditFavoritesAdd=Lisa|Lisa uus lemmik (favorite).
CommandEditFavoritesAddSystem=Lisa levinuimad|Lisa vaikimisi pakutud lemmikud.
CommandEditFavoritesDelete=Kustuta|Kustuta valitud lemmikud.
CommandEditFavoritesMoveDown=Liiguta alla|Liiguta valitud lemmikud sammu võrra alla.
CommandEditFavoritesMoveToBottom=Liiguta kõige alla|Liiguta valitud lemmikud kõige alla.
CommandEditFavoritesMoveToTop=Liiguta kõige üles|Liiguta valitud lemmikud kõige üles.
CommandEditFavoritesMoveUp=Liiguta üles|Liiguta valitud lemmikud sammu võrra üles.
CommandEditFieldIdentity=Kasuta ainumääratlusväljana|Kasuta seda välja ainumääratlusväljana (identity).
CommandEditFind=Otsi...|Find text.
CommandEditFindNext=Leia järgmine|Find next occurrence of text.
CommandEditFindPrevious=Leia eelmine|Find previous occurrence of text.
CommandEditJoin=Seosta...|Join data from another component.
CommandEditJoinAdd=Lisa|Add new field.
CommandEditJoinAddMulti=Väljad...|Add multiple fields.
CommandEditJoinDelete=Kustuta|Delete selected new fields.
CommandEditLanguageFavorites=Lemmikud...|Edit list of favorite languages.
CommandEditLanguageSelect=Veel...|Specify language.
CommandEditMerge=Mesti|Merge components.
CommandEditMergeDrawing=Mesti vektorjoonised...|Merge drawings.
CommandEditMergeImage=Mesti rasterpildid...|Merge images.
CommandEditMergeLabels=Mesti märgised...|Merge labels.
CommandEditPaste=Kleebi|Paste the contents of the clipboard.
CommandEditPasteFieldAuto=Välja automaatvalik|Select field automatically.
CommandEditPasteFieldNone=Eira välja|Ignore field.
CommandEditPropertiesDelete=Kustuta|Delete selected properties.
CommandEditPropertiesValueCopy=Kopeeri|Copy value to the clipboard.
CommandEditPropertiesValueDelete=Kustuta|Delete value.
CommandEditPropertiesValueEdit=Redigeeri...|Edit value.
CommandEditPropertiesValuePaste=Kleebi|Paste value from the clipboard.
CommandEditRecordCancel=Võta tagasi|Undo changes to record.
CommandEditRecordCommit=Salvesta muudatused|Save changes to record.
CommandEditRecordPick=Muuda kirjet|View or edit record values.
CommandEditReplace=Asenda...|Replace text.
CommandEditReplaceAll=Asenda Kõik|Replace all occurrences of text.
CommandEditReplaceNext=Asenda järgmine|Replace text and find next occurrence.
CommandEditReplacePrevious=Asenda eelmine|Replace text and find previous occurrence.
CommandEditSaveImage=Save as &Image...|Save window contents as image.
CommandEditSaveLayout=Salvesta küljendina|Save window contents as layout.
CommandEditSaveMap=Salvesta kaardina|Save window contents as map.
CommandEditSaveQuery=Salvesta päringuna|Save window contents as query.
CommandEditSaveScript=Salvesta skriptina|Save window contents as script.
CommandEditSchema=Skeem...|View and edit table schema.
CommandEditSchemaAdd=Lisa|Add new field, index or constraint.
CommandEditSchemaAddConstraint=Kitsendus...|Add new constraint.
CommandEditSchemaAddField=Väli...|Add new field.
CommandEditSchemaAddIndex=Indeks...|Add new index.
CommandEditSchemaAddSystem=Lisa ainumääratlusväli|Add identity field and index.
CommandEditSchemaDelete=Kustuta|Delete selected items.
CommandEditSchemaFilterClear=Kõik|Show all items.
CommandEditSchemaFilterConstraint=Kitsendused|Show only constraints.
CommandEditSchemaFilterField=Väljad|Show only fields.
CommandEditSchemaFilterIndex=Indeksid|Show only indexes.
CommandEditSelectAll=Vali kõik|Select all data.
CommandEditSelectClear=Tühista valik|Unselect all data.
CommandEditSelectClearMap=Tühista valik (kõik)|Unselect all data in map.
CommandEditSelectInvert=Pööra valik ümber|Invert selection.
CommandEditShape=Joonda|Edit shape of selected frames.
CommandEditShapeAlignBottom=Joonda alla|Align selected frames to bottom edge of active frame.
CommandEditShapeAlignCenterHorz=Joonda keskpunkt horisontaalselt|Align selected frames to horizontal center of active frame.
CommandEditShapeAlignCenterVert=Joonda keskpunkt vertikaalselt|Align selected frames to vertical center of active frame.
CommandEditShapeAlignLeft=Joonda vasakule|Align selected frames to left edge of active frame.
CommandEditShapeAlignRight=Joonda paremale|Align selected frames to right edge of active frame.
CommandEditShapeAlignTop=Joonda üles|Align selected frames to top edge of active frame.
CommandEditShapeList=Joonda|Edit shape of selected frames.
CommandEditShapeResizeToSelected=Muuda suurus Valitute järgi|Resize active frame to include selected frames.
CommandEditShapeSameFormat=Sama Formaat|Set format of selected frames to that of active frame.
CommandEditShapeSameHeight=Sama kõrgus|Resize selected frames to be as high as active frame.
CommandEditShapeSameWidth=Sama laius|Resize selected frames to be as wide as active frame.
CommandEditShapeStackHorz=Virnasta horisontaalselt|Stack selected frames horizontally around active frame.
CommandEditShapeStackVert=Virnasta vertikaalselt|Stack selected frames vertically around active frame.
CommandEditStyleChoicesDelete=Kustuta|Delete selected choices.
CommandEditStyleCustomColorTrack=Veel...|Select custom color.
CommandEditStyleCustomCurrent=Praegune|Select current style.
CommandEditStyleCustomFont=Font...|Select custom font.
CommandEditStyleCustomFontTrack=Veel...|Select custom font.
CommandEditStyleCustomImage=Pilt...|Select custom image.
CommandEditStyleCustomStyleTrack=Veel...|Select custom style.
CommandEditStyleDefault=Vaikimisi|Use default value.
CommandEditStyleImagesAdd=Lisa...|Add new images.
CommandEditStyleImagesClear=Tühjenda|Delete all images.
CommandEditStyleImagesDelete=Kustuta|Delete image.
CommandEditStylePickColor=Värvivalija...|Pick color from screen.
CommandEditStyleValuesDarken=Tumenda|Darken selected colors.
CommandEditStyleValuesGrayscale=Hallskaala|Convert selected colors to grayscale.
CommandEditStyleValuesInterpolate=Interpoleeri|Interpolate selected values.
CommandEditStyleValuesLighten=Helenda|Lighten selected colors.
CommandEditStyleValuesRangeAutocontrast=Autokontrast|Adjust range of used channel values to provide contrast.
CommandEditStyleValuesRangeAutocontrast10=1.0 st.hälve (kõrge)|Set range of used channel values to mean +/- 1.0 standard deviations.
CommandEditStyleValuesRangeAutocontrast15=1.5 st.hälve|Set range of used channel values to mean +/- 1.5 standard deviations.
CommandEditStyleValuesRangeAutocontrast20=2.0 st.hälve|Set range of used channel values to mean +/- 2.0 standard deviations.
CommandEditStyleValuesRangeAutocontrast25=2.5 st.hälve|Set range of used channel values to mean +/- 2.5 standard deviations.
CommandEditStyleValuesRangeAutocontrast30=3.0 st.hälve|Set range of used channel values to mean +/- 3.0 standard deviations.
CommandEditStyleValuesRangeFull=Täisvahemik|Use full range of channel values.
CommandEditStyleValuesReverse=Pööra ümber|Reverse selected values.
CommandEditTemplateParamAuto=Sama väli|Same field.
CommandEditTemplateParamAutoGeomZ=Z-väärtused|Geometry Z values.
CommandEditTemplateParamAutoSequence=Järjest numbrid|Sequential values.
CommandEditTemplateParamExpression=Avaldis|Query expression.
CommandEditTemplateParamNew=Uus väli|New field.
CommandEditTemplateParamNewTable=Uus tabel|Original field in new table component.
CommandEditTemplateParamNone=Väli puudub|No field.
CommandEditTemplateParamValue=Väärtus|Fixed value.
CommandEditTemplateParamValueNumber=Number|Fixed numeric value.
CommandEditTemplateParamValueText=Tekst|Fixed text value.
CommandEditTextCaseLower=Väiketähed|Convert selected text to lower case.
CommandEditTextCaseUpper=Suurtähed|Convert selected text to upper case.
CommandEditTextComment=Lisa kommentaarimärk|Comment selected lines.
CommandEditTextCommentRev=Eemalda kommentaarimärk|Uncomment selected lines.
CommandEditTextIndent=Suurenda taanet|Increase indent of selected lines.
CommandEditTextIndentRev=Vähenda taanet|Decrease indent of selected lines.
CommandEditUndo=Võta tagasi|Undo the last action.
CommandEditValueApplyToSelected=Muuda kõik valitud|Copy value to selected records.
CommandEditValueCancel=Võta tagasi|Undo changes to value.
CommandEditValueCopy=Kopeeri|Copy value to the clipboard.
CommandEditValueDelete=Kustuta|Delete value.
CommandEditValueEdit=Redigeeri...|Edit value.
CommandEditValueOpenCommand=Käivita käsk|Run command.
CommandEditValueOpenEmail=Saada e-mail|Send email message.
CommandEditValueOpenFile=Ava fail|Open file in external application.
CommandEditValueOpenUrl=Ava URL|Open URL in web browser.
CommandEditValuePaste=Kleebi|Paste value from the clipboard.
CommandFile=Fail|File commands.
CommandFileClose=Sulge|Close opened project.
CommandFileCreate=Lisa|Create new component.
CommandFileCreateComment=Märkmed...|Create new comments.
CommandFileCreateDataSource=Andmeläte...|Specify data source.
CommandFileCreateDataSourceFavorites=Lemmikute muutmine...|Edit list of favorite data sources.
CommandFileCreateDataSourceFavoritesList=Lingi andmeläte|Create new data source.
CommandFileCreateDrawing=Vektorjoonis...|Create new drawing.
CommandFileCreateFolder=Kaust...|Create new folder.
CommandFileCreateImage=Rasterpilt...|Create new image.
CommandFileCreateLabels=Märgised...|Create new labels.
CommandFileCreateLayout=Küljend...|Create new layout.
CommandFileCreateLocation=Asukoht...|Create new location.
CommandFileCreateMap=Kaart...|Create new map.
CommandFileCreateQuery=SQL päring...|Create new query.
CommandFileCreateScript=Skript...|Create new script.
CommandFileCreateTable=Tabel...|Create new table.
CommandFileExit=Välju|Exit application.
CommandFileExport=Ekspordi...|Export active component for use in other applications.
CommandFileExportAll=Ekspordi projekt...|Export opened project.
CommandFileImport=Impordi andmeid...|Import data from other applications.
CommandFileLink=Lingi andmeläte...|Link data from other applications.
CommandFileNew=Uus projekt|Create new project.
CommandFileOpen=Ava projekt...|Open existing project.
CommandFileOpenRecent=Hiljutised projektid|Open recently opened project.
CommandFilePageSetup=Lehekülje häälestus...|Change printing options.
CommandFilePrint=Printimine...|Print data.
CommandFilePrintPreview=Printimise eelvaade|Print data with preview.
CommandFileSave=Salvesta|Save opened project.
CommandFileSaveAs=Salvesta nimega...|Save opened project with a new name.
CommandHelp=Abi|Help commands.
CommandHelpAbout=Teave...|Display program version and copyright.
CommandHelpContext=Kiirklahvid|Show context help.
CommandHelpWebDocumentation=Kasutusjuhend|Show online documentation.
CommandHelpWebHome=Veebileht|Go to web site for {productname}.
CommandTool=Tööriistad|Tools and add-ins.
CommandToolAddins=Lisandmoodulid|Add-ins.
CommandToolAddinsRescan=Otsi uuesti...|Rescan add-ins.
CommandToolEditServices=Halda teenuseid...|Manage Manifold services.
CommandToolEditServicesAdd=Lisa...|Add new service.
CommandToolEditServicesDelete=Eemalda|Delete selected services.
CommandToolEditServicesRefresh=Värskenda|Refresh services.
CommandToolEditServicesStart=Käivita|Start selected services.
CommandToolEditServicesStop=Peata|Stop selected services.
CommandToolEditUiStrings=Redigeeri tõlkefaili...|Edit localization file.
CommandToolEditUiStringsFilterAll=Kõik|Show all strings.
CommandToolEditUiStringsFilterChanged=Redigeeritud|Show edited strings.
CommandToolEditUiStringsFilterLocalized=Tõlgitud|Show localized strings.
CommandToolEditUiStringsFilterLocalizedDef=Tõlkeks vaikeväärtus|Show localized strings with translations same as default.
CommandToolEditUiStringsFilterUnchanged=Redigeerimata|Show unedited strings.
CommandToolEditUiStringsFilterUnlocalized=Tõlkimata|Show unlocalized strings.
CommandToolOptions=Suvandid...|View and change program options.
CommandToolScanLas=Indekseeri LiDARifaile...|Preprocess LiDAR files for faster access in Manifold.
CommandToolScanRawBinary=Tuvasta binaarfail...|Scan raw binary file and prepare it for use in Manifold.
CommandToolScanRawText=Tuvasta tekstifail...|Scan raw text file and prepare it for use in Manifold.
CommandView=Vaade|View commands.
CommandViewBack=Tagasi|Go to previous view.
CommandViewBuilderInsert=Lisa koodilõik|Insert code into query text.
CommandViewBuilderInsertName=Lisa nimi|Insert name into query text.
CommandViewBuilderInsertNameQualified=Lisa tabel.nimi|Insert table and name into query text.
CommandViewBuilderInsertSchema=Lisa definitsioon|Insert table definition into query text.
CommandViewBuilderInsertSchemaFieldList=Lisa väljade loend|Insert table field list into query text.
CommandViewCommands=Ava uus käsuaken|Command windows.
CommandViewCommandsQuery=SQL|Open new command window for SQL.
CommandViewDesignBorders=Piirjooned|Show or hide margins.
CommandViewFilter=Filtreeri|Filter records.
CommandViewFilterClear=Eemalda filter|Clear filter.
CommandViewFilterQuery=Koosta päring|Compose query for current filter.
CommandViewFilterRefresh=Rakenda uuesti|Reapply filter and order.
CommandViewFilterSelection=Näita valituid|Show only selected records.
CommandViewFitFloats=Mahuta ekraanile|Fit undocked panes and windows to screen.
CommandViewForward=Järgmine|Go to next view.
CommandViewLayerAlignCenter=Joonda keskele|Center field values.
CommandViewLayerAlignLeft=Joonda vasakule|Align field values left.
CommandViewLayerAlignRight=Joonda paremale|Align field values right.
CommandViewLayerAutoSize=Mahuta|Resize field to best fit field values.
CommandViewLayerAutoSizeMulti=Mahuta|Resize one or more fields to best fit field values.
CommandViewLayerAutoSizeName=Mahuta päis|Resize field to best fit field values and field name.
CommandViewLayerAutoSizeNameMulti=Mahuta päised|Resize one or more fields to best fit field values and field name.
CommandViewLayerCenter=Paiguta keskele|Center active layer.
CommandViewLayerCenterMulti=Paiguta keskele|Center one or more layers.
CommandViewLayerCenterZoom=Suumi kihile|Zoom to active layer.
CommandViewLayerCenterZoomMulti=Suumi kihile|Zoom to one or more layers.
CommandViewLayerCenterZoomSelected=Suumi valikule|Zoom to selection in active layer.
CommandViewLayerCenterZoomSelectedMulti=Suumi valikule|Zoom to selection in one or more layers
CommandViewLayerCopy=Kopeeri|Copy field values to the clipboard.
CommandViewLayerDelete=Eemalda kaardilt|Delete active layer from map.
CommandViewLayerLegendSplit=&Split into Samples|Replace legend frame with multiple sample frames.
CommandViewLayerOpen=Ava|Open active layer.
CommandViewLayerOpenTable=Ava tabel|Open table which contains data for active layer.
CommandViewLayerOrder=Sorteeri kasvavalt|Order from small values to large.
CommandViewLayerOrderReverse=Sorteeri kahanevalt|Order from large values to small.
CommandViewLayerProperties=Atribuudid...|View and edit layer properties.
CommandViewLayerRefresh=Värskenda|Refresh active layer.
CommandViewLayerStyle=Stiil...|Edit field style.
CommandViewLayerSwitch=Tee aktiivseks|Switch active layer.
CommandViewLayerSwitchPick=Tee aktiivseks|Make layer active.
CommandViewLayerSyncLayers=Kuva kihipaanil|Show active layer in Layers pane.
CommandViewLayerSyncProject=Kuva projektipaanil|Show active layer in Project pane.
CommandViewLayerToggle=Näita/Peida|Show or hide active layer.
CommandViewLayerUseCoordSystem=Kasuta koord. süsteemi|Use layer coordinate system.
CommandViewLayers=Kihid|Show Layers pane.
CommandViewLayersCreateFolder=Uus kaust...|Create new folder.
CommandViewLayersDelete=Kustuta|Delete selected items.
CommandViewLayersFilterClear=Kõik|Show all layers.
CommandViewLayersFilterLayoutDrawing=Vektorjoonised|Show only drawings.
CommandViewLayersFilterLayoutImage=Rasterpildid|Show only images.
CommandViewLayersFilterLayoutLabels=Märgised|Show only labels.
CommandViewLayersFilterLayoutLegend=L&egends|Show only legend frames.
CommandViewLayersFilterLayoutMap=Kaardid|Show only maps.
CommandViewLayersFilterLayoutNorthArrow=&North Arrows|Show only north arrow frames.
CommandViewLayersFilterLayoutSample=Sam&ples|Show only sample frames.
CommandViewLayersFilterLayoutScaleBar=&Scale Bars|Show only scale bar frames.
CommandViewLayersFilterLayoutText=Tekstiraamid|Show only text frames.
CommandViewLayersFilterMapDrawing=Vektorjoonised|Show only drawings.
CommandViewLayersFilterMapImage=Rasterpildid|Show only images.
CommandViewLayersFilterMapLabels=Märgised|Show only labels.
CommandViewLayersFilterSelected=Nopitud|Show only picked layers.
CommandViewLayersFilterTableField=Väljad|Show only non-computed fields.
CommandViewLayersFilterTableFieldComputed=Arvutatavad väljad|Show only computed fields.
CommandViewLayersMoveDown=Liiguta alla|Move selected items one step down.
CommandViewLayersMoveToBottom=Liiguta kõige alla|Move selected items to bottom.
CommandViewLayersMoveToFolder=Liiguta kausta|Move selected items to folder.
CommandViewLayersMoveToFolderRoot=Liiguta juurkausta|Move selected items to root folder.
CommandViewLayersMoveToTop=Liiguta kõige üles|Move selected items to top.
CommandViewLayersMoveUp=Liiguta üles|Move selected items one step up.
CommandViewLayersParamLayoutAlpha=Kuva läbipaistmatus|Show frame opacity.
CommandViewLayersParamMapAlpha=Kuva läbipaistmatus|Show layer opacity.
CommandViewLayersParamMapLegend=Show &Legend Mode|Show legend mode.
CommandViewLayersParamMapOverlap=Show O&verlap Mode|Show overlap mode.
CommandViewLayersParamMapPick=Kuva nopperežiim|Show pick mode.
CommandViewLayersParamMapScale=Kuva min/max mõõtkava|Show closest scale and farthest scale.
CommandViewLayersParamMapScaleFix=Kuva viimistlus-mõõtkava|Show render scale.
CommandViewLayersParamMapSnap=Kuva napserežiim|Show snap mode.
CommandViewLayersParamTableAlign=Kuva joondusi|Show field align.
CommandViewLayersParamTableLanguage=Kuva keeli|Show field language.
CommandViewLayersParamTableSize=Kuva laiusi|Show field width.
CommandViewLayersParamTableStyle=Kuva stiile|Show field style.
CommandViewLayersParamTableType=Kuva tüüpe|Show field type.
CommandViewLocation=Asukohad|View location.
CommandViewLocationList=Asukohad|View location.
CommandViewLocationSave=Salvesta praegune asukoht|Save current location.
CommandViewLocationWindow=Aknad|View window location.
CommandViewLog=Logiaken|Open log window.
CommandViewMessages=Teated|View messages.
CommandViewMode=Režiim|Cursor modes.
CommandViewModeCoordInsert=Lisa käänupunkte|Start inserting coordinates.
CommandViewModeCoordMove=Nihuta käänupunkte|Start moving coordinates.
CommandViewModeCoordMoveSplit=Nihuta ja lisa käänupunkte|Start moving coordinates and splitting segments.
CommandViewModeCreateArea=Lisa pindobjekt|Create new area.
CommandViewModeCreateLegend=Create L&egend|Create new legend frame.
CommandViewModeCreateLine=Lisa joonobjekt|Create new line.
CommandViewModeCreateNorthArrow=Create &North Arrow|Create new north arrow frame.
CommandViewModeCreatePoint=Lisa punktobjekt|Create new point.
CommandViewModeCreateSampleArea=Lisa ala näidis|Create new area sample frame.
CommandViewModeCreateSampleColor=Lisa värvi näidis|Create new color sample frame.
CommandViewModeCreateSampleLine=Lisa joone näidis|Create new line sample frame.
CommandViewModeCreateSamplePoint=Lisa punkti näidis|Create new point sample frame.
CommandViewModeCreateSampleText=Lisa teksti näidis|Create new text sample frame.
CommandViewModeCreateScaleBar=Create &Scale Bar|Create new scale bar frame.
CommandViewModeCreateText=Lisa märgis|Create new label.
CommandViewModeDefault=Tavarežiim|Pan (drag), zoom (right-drag), select (Ctrl-drag/click), info (Alt-click).
CommandViewModeRegister=Redigeeri Ankurpunkte|Edit registration control points.
CommandViewModeTracker=Mõõtmine|Measure distances or edit geometry.
CommandViewOrder=Järjesta|Order records.
CommandViewOrderClear=Tühista järjestus|Clear order.
CommandViewOrderRefresh=Rakenda uuesti|Reapply order.
CommandViewPanes=Paanid|Show or hide panes.
CommandViewPreviewHide=Peida eelvaade|Hide preview.
CommandViewPreviewOpacity25=25%|Show preview with 25% opacity.
CommandViewPreviewOpacity50=50%|Show preview with 50% opacity.
CommandViewPreviewOpacity75=75%|Show preview with 75% opacity.
CommandViewPreviewOpacityFull=100% Opacity|Show preview with 100% opacity.
CommandViewPreviewPositionFull=Täislaius|Show preview using full width.
CommandViewPreviewPositionLeft=Vasak|Show preview on left side.
CommandViewPreviewPositionRight=Parem|Show preview on right side.
CommandViewPreviewValues=Tulemused|Show or hide preview results.
CommandViewProject=Projektipaan|Show or hide Project pane.
CommandViewProjectActivateLocation=Vaata|View location in associated component.
CommandViewProjectApplyLocation=Vaata aktiivses aknas|View location in active window.
CommandViewProjectCommand=Uus käsuaken|Open new command window.
CommandViewProjectCopy=Kopeeri|Copy selected components to the clipboard.
CommandViewProjectCreate=Lisa|Lisa uus komponent (component).
CommandViewProjectCreateComment=Märkmed...|Lisa uus märkmete komponent (comments).
CommandViewProjectCreateDataSource=Uus andmeläte...|Specify data source.
CommandViewProjectCreateDataSourceFavorites=Lemmikute muutmine...|Edit list of favorite data sources.
CommandViewProjectCreateDataSourceFavoritesList=Andmeläte|Lisa uus andmeläte (data source).
CommandViewProjectCreateDrawing=Vektorjoonis...|Lisa uus vektorjoonis (drawing).
CommandViewProjectCreateFolder=Kaust...|Lisa uus kaust (folder).
CommandViewProjectCreateImage=Rasterpilt...|Lisa uus rasterpilt (image).
CommandViewProjectCreateLabels=Märgised...|Lisa uus märgiste kiht (labels).
CommandViewProjectCreateLayout=Küljend...|Lisa uus küljend (layout).
CommandViewProjectCreateLocation=Asukoht...|Lisa uus asukoht (location).
CommandViewProjectCreateMap=Kaart...|Lisa uus kaart (map).
CommandViewProjectCreateQuery=SQL päring...|Lisa uus SQL päring (query).
CommandViewProjectCreateScript=Skript...|Lisa uus skript (script).
CommandViewProjectCreateTable=Tabel...|Lisa uus tabel (table).
CommandViewProjectCut=Lõika|Cut selected components and move them to the clipboard.
CommandViewProjectDelete=Kustuta|Delete selected components.
CommandViewProjectDeleteRelated=Kustuta seotud...|Delete related components.
CommandViewProjectExport=Ekspordi...|Export data for use in other applications.
CommandViewProjectFilterClear=Kõik|Show all components.
CommandViewProjectFilterComment=Märkmed|Show only comments.
CommandViewProjectFilterDataSource=Andmelätted|Show only data sources.
CommandViewProjectFilterDrawing=Vektorjoonised|Show only drawings.
CommandViewProjectFilterImage=Rasterpildid|Show only images.
CommandViewProjectFilterLabels=Märgised|Show only labels.
CommandViewProjectFilterLayout=Küljendid|Show only layouts.
CommandViewProjectFilterLocation=Asukohad|Show only locations.
CommandViewProjectFilterMap=Kaardid|Show only maps.
CommandViewProjectFilterQuery=Päringud|Show only queries.
CommandViewProjectFilterScript=Skriptid|Show only scripts.
CommandViewProjectFilterSortByName=Nime järgi|Sort components by name.
CommandViewProjectFilterSortByType=Tüübi järgi|Sort components by type.
CommandViewProjectFilterTable=Tabelid|Show only tables.
CommandViewProjectIndex=Indekseeri ülejäänud failid|Process data in excluded files to include them into library.
CommandViewProjectMigrate=Siirda Enterprise Storage|Copy data in Manifold 8 Enterprise Storage to regular tables.
CommandViewProjectOpen=Ava|Open component.
CommandViewProjectPaste=Kleebi|Paste one or more components from the clipboard.
CommandViewProjectProperties=Atribuudid...|View and edit component or folder properties.
CommandViewProjectReconnect=Ühenda uuesti|Reconnect to data source.
CommandViewProjectRefresh=Värskenda|Refresh data source.
CommandViewProjectRenameRelated=Nimeta ümber seotud...|Rename related components.
CommandViewProjectRun=Käivita|Run component.
CommandViewProjectSave=Salvesta|Save data source.
CommandViewProjectSaveCompact=Tihenda|Compact data source, optimizing storage.
CommandViewProjectSchema=Skeem...|View and edit table schema.
CommandViewProjectShowRelated=Näita seotud...|Show related components.
CommandViewProperties=Atribuudid...|View and edit component properties.
CommandViewRecord=Info|Show Info pane.
CommandViewRecordCoordAdd=Lisa keskele|Add coordinate in middle of segment.
CommandViewRecordCoordAddSpline=Lisa splaini käänupunkt|Add spline coordinate.
CommandViewRecordCoordBranchBegin=Alusta uut haru|Begin new branch.
CommandViewRecordCoordBranchContinue=Jätka haru|Continue branch from coordinate.
CommandViewRecordCoordBranchContinueLast=Jätka viimase haruga|Continue last branch.
CommandViewRecordCoordBranchDelete=Kustuta haru|Delete branch.
CommandViewRecordCoordBranchEnd=Lõpeta see haru|End current branch.
CommandViewRecordCoordBranchEndClose=Lõpeta see haru ja sulge vahe|End current branch, close gap between start and end using compass rule.
CommandViewRecordCoordBranchReverse=Pööra haru suund ringi|Reverse branch direction.
CommandViewRecordCoordClip=Kärbi...|Clip geometry using other records.
CommandViewRecordCoordCopyValue=Kopeeri|Copy value to the clipboard.
CommandViewRecordCoordCopyValueList=Kopeeri koordinaadid|Copy coordinate list to the clipboard.
CommandViewRecordCoordCurveCircle=Teisenda ringikaareks|Convert segment to circle arc.
CommandViewRecordCoordCurveEllipse=Teisenda ellipsikaareks|Convert segment to ellipse arc.
CommandViewRecordCoordCurveLine=Teisenda jooneks|Convert segment to straight line.
CommandViewRecordCoordCurveSpline=Teisenda splainiks|Convert segment to spline.
CommandViewRecordCoordDelete=Kustuta käänupunkt|Delete coordinate.
CommandViewRecordCoordDeleteLast=Kustuta viimane käänupunkt|Delete last coordinate.
CommandViewRecordCoordDeleteMulti=Kustuta|Delete selected coordinates.
CommandViewRecordCoordEdit=Redigeeri koordinaate|Switch to editing coordinates.
CommandViewRecordCoordErase=Kustuta...|Erase geometry in other records.
CommandViewRecordCoordLoad=Laadi...|Load coordinates from file.
CommandViewRecordCoordMerge=Mesti...|Merge geometry from other records into edited record.
CommandViewRecordCoordModePlain=Näita käänupunkte|Show coordinates.
CommandViewRecordCoordModeTraverse=Näita käiku|Show traverse.
CommandViewRecordCoordSave=Salvesta...|Save coordinates to file.
CommandViewRecordCoordSplit=Jaota...|Split geometry in other records.
CommandViewRecordCoordTraverseCircleAngleArc=Angle + Arc|Define selected arcs using central angle and arc length.
CommandViewRecordCoordTraverseCircleAngleChord=Angle + Chord|Define selected arcs using central angle and chord length.
CommandViewRecordCoordTraverseCircleAngleRadius=Angle + Radius|Define selected arcs using central angle and radius.
CommandViewRecordCoordTraverseCircleArcChord=Arc + Chord|Define selected arcs using arc length and chord length.
CommandViewRecordCoordTraverseCircleArcRadius=Arc + Radius|Define selected arcs using arc length and radius.
CommandViewRecordCoordTraverseCircleChordRadius=Chord + Radius|Define selected arcs using chord length and radius.
CommandViewRecordCoordTraverseCircleDirectionChord=Chord Direction|Define selected arcs using chord direction, make arcs non-tangent.
CommandViewRecordCoordTraverseCircleDirectionRadial=Radial Direction|Define selected arcs using radial direction, make arcs non-tangent.
CommandViewRecordCoordTraverseCircleDirectionTangent=Tangent Direction|Define selected arcs using tangent direction.
CommandViewRecordCoordTraverseEdit=Traverse Parameters...|Edit traverse parameters...
CommandViewRecordCoordTraverseLineAngle=Angle + Distance|Encode selected coordinates using angle relative to current course and distance.
CommandViewRecordCoordTraverseLineDirection=Direction + Distance|Encode selected coordinates using direction and distance.
CommandViewRecordGo=Mine|Go to current record.
CommandViewRecordJoin=Seadista...|Specify source component and criteria for related records.
CommandViewRecordJoinRefresh=Värskenda|Refresh related records.
CommandViewRecordMoveNext=Liigu järgmisele|Move to next record.
CommandViewRecordMovePrevious=Liigu eelmisele|Move to previous record.
CommandViewRecordSelection=Ainult valitud|Move only to selected records.
CommandViewRecordValueCancel=Võta tagasi|Undo changes to value.
CommandViewRecordValueCopy=Kopeeri|Copy value to the clipboard.
CommandViewRecordValueDelete=Kustuta|Delete value.
CommandViewRecordValueEdit=Redigeeri...|Edit value.
CommandViewRecordValueFilter=Lisa filter|Add filter for values.
CommandViewRecordValueOpenCommand=Käivita käsk|Run command.
CommandViewRecordValueOpenEmail=Saada e-kiri|Send email message.
CommandViewRecordValueOpenFile=Ava fail|Open file in external application.
CommandViewRecordValueOpenUrl=Ava URL|Open URL in web browser.
CommandViewRecordValuePaste=Kleebi|Paste value from the clipboard.
CommandViewRecordValueViewGeom=Näita käänupunkte|View coordinate values.
CommandViewRecordValueViewTile=Näita piksleid|View pixel values.
CommandViewRefresh=Värskenda|Refresh component.
CommandViewRegister=Koordinaatimine|Show Register pane.
CommandViewRegisterAuto=Soovita asukohta|Suggest locations for selected control points.
CommandViewRegisterDelete=Kustuta|Delete selected control points.
CommandViewRegisterList=Salvestatud sidumispunktid|Load or save control points.
CommandViewRegisterModeCoords=Näita koordinaate|Show coordinates.
CommandViewRegisterModeErrors=Näita viga|Show registration errors.
CommandViewRegisterModeMarks=Kuva märke|Show coordinate marks.
CommandViewRegisterSave=Salvesta sidumispunktid|Save control points.
CommandViewRun=Käivita|Run query or script.
CommandViewRunSelection=Käivita valitud|Run selected text.
CommandViewRunSelectionEval=Väärtusta valitud avaldis|Evaluate selected text.
CommandViewSelect=Valimine|Show Select pane.
CommandViewSelectPersistentDelete=Kustuta|Delete selected fields.
CommandViewSelectPersistentUpdate=Säilita|Capture current selection into selected fields.
CommandViewSnapActive=Snäpi ainult aktiivsele kihile|Restrict snap to active layer.
CommandViewSnapBearing=Snäpi asimuudile|Snap to bearing.
CommandViewSnapBearingRelative=Snäpi suhtelisele asimuudile|Snap to bearing relative to last bearing.
CommandViewSnapCoords=Snäpi käänupunktidele|Snap to coordinates.
CommandViewSnapEdit=Snäpi seadistamine...|Edit snap parameters.
CommandViewSnapGrid=Snäpi ruutvõrgule|Snap to grid.
CommandViewSnapToggle=Snäpi|Toggle snap on or off.
CommandViewStatusCounts=Loendurid|Show or hide total number of records and number of selected records.
CommandViewStatusCountsRefresh=Värskenda|Refresh total number of records and number of selected records.
CommandViewStatusPosition=Koordinaadid|Show or hide position.
CommandViewStatusPositionLatLon=Laiuskraad / pikkuskraad
CommandViewStatusPositionLatLonMin=Laiuskraad / pikkuskraad (kraad-min)
CommandViewStatusPositionLatLonMinSec=Laiuskraad / pikkuskraad (kraad-min-sek)
CommandViewStatusPositionLocal=Pikslikoordinaadid
CommandViewStatusPositionSystem=Projektsioonikoordinaadid
CommandViewStatusScale=Mõõtkava|Show or hide scale.
CommandViewStatusScaleAbsolute=&Absolute|Show scale as 1:xxx absolute value.
CommandViewStatusScaleCustom=Määra mõõtkava...|Specify custom scale.
CommandViewStatusScaleSizePixel=&Pixel Size|Show scale as pixel size in coordinate system units.
CommandViewStatusScaleSizeView=&View Size|Show scale as view size in coordinate system units.
CommandViewStyle=Stiilid|Show Style pane.
CommandViewStyleChannels=Määra kanalid|Set channels according to built-in preset.
CommandViewStyleDelete=Kustuta|Delete selected values.
CommandViewStylePalette=Rakenda palett|Set colors of listed values using built-in palette.
CommandViewStyleRefresh=Värskenda statistikat|Refresh statistics.
CommandViewSyncProject=Kuva projektipaanil|Show active component in Project pane.
CommandViewTrackerClear=Puhasta mõõtmine|Clear tracker coordinates.
CommandViewTrackerCopyBearing=Kopeeri asimuut|Copy last bearing.
CommandViewTrackerCopyLength=Kopeeri pikkus|Copy total length.
CommandViewTrackerCopyPosition=Kopeeri koordinaat (projektsioonis)|Copy last location, projected coordinates.
CommandViewTrackerCopyPositionLatLon=Kopeeri koordinaat|Copy last location, latitude / longitude.
CommandViewTransform=Teisendused|Show Transform pane.
CommandViewZoomAll=Mahuta|Set screen magnification to view entire component.
CommandViewZoomIn=Suumi sisse|Increase screen magnification.
CommandViewZoomNative=Suumi 100%|Set screen magnification to native scale.
CommandViewZoomOut=Suumi välja|Decrease screen magnification.
CommandWindow=Aken|Window commands.
CommandWindowClose=Sulge|Close window.
CommandWindowCloseAll=Sulge kõik|Close all windows.
CommandWindowCloseTab=Sulge|Close window.
CommandWindowDock=Doki|Dock window.
CommandWindowDockDown=Doki alla|Move docked window down.
CommandWindowDockLeft=Doki vasakule|Move docked window left.
CommandWindowDockRight=Doki paremale|Move docked window right.
CommandWindowDockUp=Doki üles|Move docked window up.
CommandWindowFloat=Doki lahti|Undock window.
CommandWindowNew=Ava uues aknas|Open another window for active component.
CommandWindowNext=Järgmine|Switch to next window.
CommandWindowPrevious=Eelmine|Switch to previous window.
CommandWindowWindows=Aknad...|Manage opened windows.
CommandWindowWindowsClose=Sulge|Close selected windows.

# <name>
DialogAnyCtlApply=Rakenda
DialogAnyCtlCancel=Loobu
DialogAnyCtlClose=Sulge
DialogAnyCtlOK=OK
DialogEditCollate=Sorteerimisalus
DialogEditCollateCtlNoAccent=Eira diakriitikuid
DialogEditCollateCtlNoCase=Eira tõstet
DialogEditCollateCtlNoKanaType=Eira -kana tüüpi
DialogEditCollateCtlNoSymbols=Eira sümboleid
DialogEditCollateCtlNoWidth=Eira laiust
DialogEditCollateCtlTabBuiltin=Standard
DialogEditCollateCtlTabCustom=Kohandatud
DialogEditCollateCtlTabDatabase=Andmebaas
DialogEditCollateCtlWordSort=Sõna-sorteerimine
DialogEditConfirm=Kinnita toiming
DialogEditConfirmCtlDisable=Ära enam küsi
DialogEditCoordBase=Daatum
DialogEditCoordBaseCtlName=Nimi:
DialogEditCoordBaseCtlTabBuiltin=Standard
DialogEditCoordBaseCtlTabCustom=Kohandatud
DialogEditCoordBaseCtlTabEpsg=EPSG
DialogEditCoordBaseCtlType=To WGS84:
DialogEditCoordLocals=projektsiooni ühikud
DialogEditCoordLocalsCtlUnit=XY:
DialogEditCoordLocalsCtlUnitScaleCustom=Kohandatud ühikud
DialogEditCoordLocalsCtlUnitZ=Z:
DialogEditCoordParam=Ühikute teisendaja
DialogEditCoordParamCtlSource=Originaal:
DialogEditCoordParamCtlTarget=Resultaat:
DialogEditCoordSystem=projektsioon
DialogEditCoordSystemCtlAxes=Teljed:
DialogEditCoordSystemCtlAxesForceXY=Rakenda XY-teljestik
DialogEditCoordSystemCtlBase=Daatum:
DialogEditCoordSystemCtlLocals=Ühikud:
DialogEditCoordSystemCtlName=Nimi:
DialogEditCoordSystemCtlTabBuiltin=Standard
DialogEditCoordSystemCtlTabCustom=Kohandatud
DialogEditCoordSystemCtlTabEpsg=EPSG
DialogEditCoordSystemCtlTabSrid=Andmebaas
DialogEditCoordSystemCtlType=Tüüp:
DialogEditCoordSystemChange=Muuda projektsiooni
DialogEditCoordSystemChangeCtlAddEntity=Lisa komponent
DialogEditCoordSystemChangeCtlDiv=Piksli jaotisi:
DialogEditCoordSystemChangeCtlEditField=Muuda komponent
DialogEditCoordSystemChangeCtlPath=Teisendus:
DialogEditCoordSystemChangeCtlPathDefault=vaikimisi
DialogEditCoordSystemChangeCtlPathDefaultEmpty=vaikimisi (koordinaatsüsteemid on samad)
DialogEditCoordSystemChangeCtlPathDefaultScaleShiftSwap=vaikimisi (koordinaatsüsteemid on samad v.a. ühikud, nihked, telgede jrk)
DialogEditCoordSystemChangeCtlQuery=Ava päringuna
DialogEditCoordSystemChangeCtlRender=Renderda:
DialogEditCoordSystemChangeCtlScale=Komponendi mõõtkavategurid:
DialogEditCoordSystemChangeCtlScaleAuto=Auto
DialogEditCoordSystemChangeCtlShift=Komponendi nihked:
DialogEditCoordSystemChangeCtlShiftAuto=Auto
DialogEditCoordSystemChangeCtlSource=Praegune:
DialogEditCoordSystemChangeCtlTarget=Uus:
DialogEditCoordSystemChangeCtlThreads=Luba rööptöötlus
DialogEditCoordSystemChangeCtlTile=Tailid:
DialogEditCoordSystemChangeCtlTileAuto=Auto
DialogEditCoordSystemChangePath=Teisendus
DialogEditDescription=Kirjeldus
DialogEditExpression=Avaldis
DialogEditExpressionPattern=Tekst
DialogEditExpressionPatternCtlPrompt=Välja lisamiseks kasuta: [väli]\nAvaldise lisamiseks kasuta: [[ <avaldis> ]]
DialogEditFavorites=Lemmikud
DialogEditFavoritesCtlAdd=Lisa lemmikutesse
DialogEditFind=Otsi
DialogEditFindCtlFind=Otsi:
DialogEditFindCtlFindNext=Järgmine
DialogEditFindCtlFindPrevious=Eelmine
DialogEditFindCtlNoCase=Eira tõstet
DialogEditFindCtlReplace=Asenda:
DialogEditFindCtlReplaceAll=Asenda kõik
DialogEditFindCtlReplaceNext=Asenda
DialogEditFindCtlWhole=Terve sõna
DialogEditFindReplace=Asenda
DialogEditGeomClip=Kärbi
DialogEditGeomClipCtlInner=Kärbi välimine osa
DialogEditGeomClipCtlSelection=Ainult valitud kirjed
DialogEditGeomErase=Kustuta
DialogEditGeomEraseCtlInner=Kustuta välimine osa
DialogEditGeomEraseCtlSelection=Ainult valitud kirjed
DialogEditGeomMerge=Mesti
DialogEditGeomMergeCtlSelection=Ainult valitud kirjed
DialogEditGeomSplit=Jaota
DialogEditGeomSplitCtlSelection=Ainult valitud kirjed
DialogEditGrid=Grid
DialogEditGridCtlDashes=Dashes:
DialogEditGridCtlDashesDesc=dash, space, ...
DialogEditGridCtlHalo=Halo:
DialogEditGridCtlLatLon=Use latitude / longitude
DialogEditGridCtlSize=Point size:
DialogEditGridCtlStep=Step:
DialogEditGridCtlStepGrow=Increase step on zoom out
DialogEditGridCtlStroke=Stroke:
DialogEditGridCtlUnit=Unit:
DialogEditJoin=Seosta
DialogEditJoinCtlConditionAdjacent=külgnevad
DialogEditJoinCtlConditionContained=sisaldab
DialogEditJoinCtlConditionContainedPixels=sisaldab
DialogEditJoinCtlConditionContaining=sisaldub
DialogEditJoinCtlConditionContainingPixels=sisaldub
DialogEditJoinCtlConditionEqual=võrdne
DialogEditJoinCtlConditionIntersecting=lõikuvad
DialogEditJoinCtlConditionMatchingPixels=vastav
DialogEditJoinCtlConditionTouching=puutuvad
DialogEditJoinCtlImageClear=Tühjenda pikslid
DialogEditJoinCtlImageResize=Muuda pildi suurust
DialogEditJoinCtlJoin=Seosta komponent
DialogEditJoinCtlQuery=Lisa vajalikud veerud ja ava päringuna
DialogEditJoinFields=Lisa välju
DialogEditJoinRecord=Seotud
DialogEditLanguage=Keel
DialogEditLegend=Lisa legend
DialogEditLegendCtlAlign=Position:
DialogEditLegendCtlMargin=Margin:
DialogEditLegendCtlPadding=Padding:
DialogEditLegendCtlSize=Size:
DialogEditLegendCtlStroke=Stroke:
DialogEditLegendCtlText=Single
DialogEditLegendCtlTextGuide=Multiple
DialogEditLegendCtlTextHeader=Text
DialogEditMerge=Mesti
DialogEditMergeCtlAddFields=Kopeeri kõik väljad
DialogEditMergeCtlAddSource=Salvesta iga kirje lähtefaili nimi
DialogEditMergeCtlCoordSystem=projektsioon:
DialogEditMergeCtlMerge=Mesti
DialogEditMergeCtlName=Nimi:
DialogEditMergeCtlSkipNulls=Jäta ruumikujuta kirjed vahele
DialogEditMergeCtlSkipNullsLabels=Jäta ruumikujuta või tekstita kirjed vahele
DialogEditNorthArrow=North Arrow
DialogEditNorthArrowCtlAlign=Position:
DialogEditNorthArrowCtlBearing=Bearing:
DialogEditNorthArrowCtlBearingAuto=Auto
DialogEditNorthArrowCtlHalo=Halo:
DialogEditNorthArrowCtlMargin=Margin:
DialogEditNorthArrowCtlSize=Size:
DialogEditNorthArrowCtlStroke=Stroke:
DialogEditNorthArrowCtlText=NESW:
DialogEditNorthArrowCtlTextUse=Text
DialogEditOdbcDsn=Manifold ODBC andmeläte
DialogEditOdbcDsnCtlDataSource=Andmeläte:
DialogEditOdbcDsnCtlName=Nimi:
DialogEditOdbcDsnCtlPath=Rada:
DialogEditOdbcDsnCtlReadOnly=Ava kirjutuskaitstult
DialogEditOdbcDsnCtlUseDataSource=Kasuta MAP failist andmelätet
DialogEditOdbcDsnCtlUseFile=Kasuta MAP faili
DialogEditOdbcDsnFile=Vali fail
DialogEditPage=Lehekülje häälestus
DialogEditPageCtlMarginMax=Parem / ülemine äär:
DialogEditPageCtlMarginMin=Vasak / alumine äär:
DialogEditPageCtlPaper=Formaat:
DialogEditPageCtlSize=Laius / kõrgus:
DialogEditPaste=Kleebi
DialogEditRelatedDelete=Kustuta seotud
DialogEditRelatedDeleteCtlDelete=Kustuta
DialogEditRelatedRename=Nimeta ümber seotud
DialogEditRelatedRenameCtlRename=Nimeta ümber
DialogEditRelatedShow=Näita seotud
DialogEditRender=Save as Image
DialogEditRenderCtlDpi=DPI:
DialogEditRenderCtlName=Name:
DialogEditRenderCtlQuery=Edit Query
DialogEditRenderCtlRender=Render
DialogEditRenderCtlSize=Size:
DialogEditRenderCtlSizeScale=Current Scale
DialogEditRenderCtlSizeWindow=Current Window
DialogEditRenderCtlView=View:
DialogEditRenderCtlViewEdit=Edit...
DialogEditRenderCtlVirtual=Render virtual layers
DialogEditRenderView=Edit View
DialogEditRenderViewCtlX=X:
DialogEditRenderViewCtlY=Y:
DialogEditScale=Mõõtkava
DialogEditScaleBar=Scale Bar
DialogEditScaleBarCtlAlign=Position:
DialogEditScaleBarCtlHalo=Halo:
DialogEditScaleBarCtlLength=Length:
DialogEditScaleBarCtlLengthAuto=Auto
DialogEditScaleBarCtlMargin=Margin:
DialogEditScaleBarCtlSize=Size:
DialogEditScaleBarCtlStroke=Stroke:
DialogEditScaleBarCtlTextUse=Text
DialogEditScaleBarCtlUnit=Unit:
DialogEditScaleCtlSize=Size:
DialogEditScaleCtlType=Set:
DialogEditScaleLimits=Mõõtkavad
DialogEditScaleLimitsCtlScaleCurrent=Praegune mõõtkava, 1:
DialogEditScaleLimitsCtlScaleFix=Viimistlus-mõõtkava, 1:
DialogEditScaleLimitsCtlScaleMax=Vähim (kaugeim) mõõtkava, 1:
DialogEditScaleLimitsCtlScaleMin=Suurim (lähim) mõõtkava, 1:
DialogEditSchema=Skeem
DialogEditSchemaCtlQuery=Ava päringuna
DialogEditSchemaCtlSave=Salvesta muudatused
DialogEditSchemaConstraint=Kitsendus
DialogEditSchemaConstraintCtlExpression=Muuda avaldist...
DialogEditSchemaConstraintCtlName=Nimi:
DialogEditSchemaConstraintCtlTabExpression=Avaldis
DialogEditSchemaConstraintCtlTabExpressionContext=Avaldise kontekst
DialogEditSchemaConstraintCtlTemplate=Mall:
DialogEditSchemaExpression=Avaldis
DialogEditSchemaExpressionCtlTabExpression=Avaldis
DialogEditSchemaExpressionCtlTabExpressionContext=Avaldise kontekst
DialogEditSchemaField=Väli
DialogEditSchemaFieldCtlAutogenerated=Genereeri väärtused automaatselt
DialogEditSchemaFieldCtlCoordSystem=projektsioon:
DialogEditSchemaFieldCtlExpression=Muuda avaldist...
DialogEditSchemaFieldCtlGeomBounds=Piirid:
DialogEditSchemaFieldCtlGeomType=Ruumikuju:
DialogEditSchemaFieldCtlGeomZ=Z väärtused
DialogEditSchemaFieldCtlName=Nimi:
DialogEditSchemaFieldCtlTabExpression=Avaldis
DialogEditSchemaFieldCtlTabExpressionContext=Avaldise kontekst
DialogEditSchemaFieldCtlTileReduce=Kahanda:
DialogEditSchemaFieldCtlTileType=Pikslid:
DialogEditSchemaFieldCtlType=Tüüp:
DialogEditSchemaIndex=Indeks
DialogEditSchemaIndexCtlDescending=Kahanev
DialogEditSchemaIndexCtlDuplicates=Luba duplikaate
DialogEditSchemaIndexCtlField=Väli:
DialogEditSchemaIndexCtlFieldGeom=Ruumikuju:
DialogEditSchemaIndexCtlFieldTile=Tail:
DialogEditSchemaIndexCtlFieldX=X:
DialogEditSchemaIndexCtlFieldY=Y:
DialogEditSchemaIndexCtlName=Nimi:
DialogEditSchemaIndexCtlNulls=Luba NULL
DialogEditSchemaIndexCtlTileReduce=Kahanda:
DialogEditSchemaIndexCtlTileType=Pikslid:
DialogEditSchemaIndexCtlType=Tüüp:
DialogEditServerLogin=Andmebaasi logimine
DialogEditServerLoginCtlDatabase=Andmebaas:
DialogEditServerLoginCtlLogin=Kasutajanimi:
DialogEditServerLoginCtlPassword=Parool:
DialogEditServerLoginCtlServer=Server:
DialogEditServerLoginCtlTest=Testi
DialogEditServerLoginCtlUseLogin=Logi kasutajanime ja parooliga
DialogEditServerWebLogin=Veebiühendus
DialogEditServerWebLoginCtlAgent=Kasutajaagent:
DialogEditServerWebLoginCtlApiKey=API võti:
DialogEditServerWebLoginCtlApplicationKey=Rakenduse võti:
DialogEditServerWebLoginCtlLogin=Kasutajanimi:
DialogEditServerWebLoginCtlPassword=Parool:
DialogEditServerWebLoginCtlProxy=Puhverserver:
DialogEditServerWebLoginCtlProxyLogin=Kasutajanimi:
DialogEditServerWebLoginCtlProxyPassword=Parool:
DialogEditServerWebLoginCtlServer=Server:
DialogEditServerWebLoginCtlTest=Testi
DialogEditServerWebLoginCtlTimeout=Aegumine:
DialogEditServerWebLoginCtlTimeoutPostfix=msek, vaikeväärtuseks pane 0
DialogEditServerWebLoginCtlUseLogin=Logi kasutajanime ja parooliga
DialogEditServerWebLoginCtlUseProxy=Kasuta puhverserverit
DialogEditStyle=Sümbol
DialogEditStyleArea=Ala stiil
DialogEditStyleCtlAlign=Joonda:
DialogEditStyleCtlAngleOffset=Nurk / nihe:
DialogEditStyleCtlBase=Alusjoon:
DialogEditStyleCtlBend=Kääna:
DialogEditStyleCtlBendSpacing=Vahekaugus käänul:
DialogEditStyleCtlDashCap=Kriipsu ots:
DialogEditStyleCtlDashes=Kriipsud:
DialogEditStyleCtlDashesDesc=kriips, vahe, ...
DialogEditStyleCtlHalo=Halo
DialogEditStyleCtlInsert=Sisestus:
DialogEditStyleCtlLineAbove=Eelista paigutust joone kohal
DialogEditStyleCtlLineBind=Märgis:
DialogEditStyleCtlLineSpacing=Vahekaugus kordusele:
DialogEditStyleCtlLineTolerance=Üldistamise määr:
DialogEditStyleCtlMargin=Vahekaugus ülekattele:
DialogEditStyleCtlMove=Nihuta
DialogEditStyleCtlOffsetLeftRight=Vasak- / paremnihe:
DialogEditStyleCtlOffsetInnerOuter=Sisse- / väljanihe:
DialogEditStyleCtlPadding=Täide:
DialogEditStyleCtlPointBind=Label:
DialogEditStyleCtlPointShake=Move to avoid overlap
DialogEditStyleCtlPositionLine=Rida
DialogEditStyleCtlPositionPoint=Point
DialogEditStyleCtlPositionText=Tekst
DialogEditStyleCtlShadow=Vari
DialogEditStyleCtlShapes=Kujundid:
DialogEditStyleCtlShapesDesc=kujund, vahe, ...
DialogEditStyleCtlSizeInsert=Sisestuse suurus:
DialogEditStyleCtlStroke=Pliiatsitõmme:
DialogEditStyleCtlTabBegin=Algus
DialogEditStyleCtlTabBorder=Äär
DialogEditStyleCtlTabBox=Kast
DialogEditStyleCtlTabEnd=Lõpp
DialogEditStyleCtlTabIcon=Ikoon
DialogEditStyleCtlTabInner=Sisemine
DialogEditStyleCtlTabInnerBorder=Sisemine äär
DialogEditStyleCtlTabLeft=Vasak
DialogEditStyleCtlTabOuter=Välimine
DialogEditStyleCtlTabOuterBorder=Välimine äär
DialogEditStyleCtlTabPosition=Positsioon
DialogEditStyleCtlTabRight=Parem
DialogEditStyleCtlTabSymbol=Sümbol
DialogEditStyleCtlUseBegin=Algus
DialogEditStyleCtlUseBorder=Äär
DialogEditStyleCtlUseBox=Kast
DialogEditStyleCtlUseEnd=Lõpp
DialogEditStyleCtlUseIcon=Ikoon
DialogEditStyleCtlUseInner=Sisemine
DialogEditStyleCtlUseInnerBorder=Sisemine äär
DialogEditStyleCtlUseLeft=Vasak
DialogEditStyleCtlUseOuter=Välimine
DialogEditStyleCtlUseOuterBorder=Välimine äär
DialogEditStyleCtlUseRight=Parem
DialogEditStyleCtlWidth=Laius:
DialogEditStyleLine=Joonestiil
DialogEditStylePoint=Punktistiil
DialogEditStyleText=Märgiste stiil
DialogEditStyleValue=Stiil
DialogEditStyleValueCtlChoiceLabel=Näita kui
DialogEditStyleValueCtlChoiceValue=Väärtus
DialogEditStyleValueCtlDigits=Numbreid:
DialogEditStyleValueCtlLanguage=Keel:
DialogEditStyleValueCtlPattern=Muster:
DialogEditStyleValueCtlSide=Telje pos. suund:
DialogEditStyleValueCtlTabChoice=Valik
DialogEditStyleValueCtlTabCustom=Kahandatud
DialogEditStyleValueCtlTabStandard=Standard
DialogFileCreateComment=Uued märkmed
DialogFileCreateCommentCtlCreate=Lisa märkmed
DialogFileCreateCommentCtlName=Nimi:
DialogFileCreateCommentCtlQuery=Ava päringuna
DialogFileCreateDataSource=Uus andmeläte
DialogFileCreateDataSourceCtlAllowYX=Loe koordinaate YX-järjestuses, kui projektsioon nii ette näeb
DialogFileCreateDataSourceCtlApiKey=API võti:
DialogFileCreateDataSourceCtlApplicationKey=Rakenduse võti:
DialogFileCreateDataSourceCtlCache=Puhverda andmeid
DialogFileCreateDataSourceCtlCachePersistent=Rakenduse sulgemisel säilita puhver.
DialogFileCreateDataSourceCtlCacheSmart=Puhverda ainult neid andmeid, mis muidu oleks aeglased
DialogFileCreateDataSourceCtlCharDecimal=Komamärk:
DialogFileCreateDataSourceCtlCharList=Eraldaja:
DialogFileCreateDataSourceCtlCharQuote=Tekstitäpsusti:
DialogFileCreateDataSourceCtlCoordSystem=Eelistatud projektsiooni ID:
DialogFileCreateDataSourceCtlCreate=Lisa andmeläte
DialogFileCreateDataSourceCtlCreateFavorite=Lisa lemmikutesse
DialogFileCreateDataSourceCtlFieldHeader=Esimene rida on väljanimed
DialogFileCreateDataSourceCtlForceText=Loe kõiki välju tekstina
DialogFileCreateDataSourceCtlLinkDepth=Linkide järgimise sügavus:
DialogFileCreateDataSourceCtlMargins=Lõika ääris
DialogFileCreateDataSourceCtlMergeLayers=Mesti kihid
DialogFileCreateDataSourceCtlMultiline=Luba mitmerealist teksti
DialogFileCreateDataSourceCtlName=Nimi:
DialogFileCreateDataSourceCtlQuery=Ava päringuna
DialogFileCreateDataSourceCtlReadOnly=Ava kirjutuskaitstult
DialogFileCreateDataSourceCtlReverseY=Pööra Y
DialogFileCreateDataSourceCtlSaveQueued=Tõrketaluvusega salvestamine
DialogFileCreateDataSourceCtlSource=Aadress:
DialogFileCreateDataSourceCtlSubfolders=Loe alamkaustu
DialogFileCreateDataSourceCtlTileSize=Taili suurus:
DialogFileCreateDataSourceCtlType=Tüüp:
DialogFileCreateDataSourceCtlZooms=Suumivahemik:
DialogFileCreateDataSourceFile=Vali fail
DialogFileCreateDataSourceFolder=Vali kaust
DialogFileCreateDrawing=Uus vektorjoonis
DialogFileCreateDrawingCtlCoordSystem=projektsioon:
DialogFileCreateDrawingCtlCreate=Lisa vektorjoonis
DialogFileCreateDrawingCtlGeometry=Ruumikuju:
DialogFileCreateDrawingCtlIndex=Loo ruumiindeks
DialogFileCreateDrawingCtlName=Nimi:
DialogFileCreateDrawingCtlQuery=Ava päringuna
DialogFileCreateDrawingCtlTable=Tugineb:
DialogFileCreateFolder=Uus kaust
DialogFileCreateFolderCtlCreate=Lisa kaust
DialogFileCreateFolderCtlPath=Rada:
DialogFileCreateFolderCtlQuery=Ava päringuna
DialogFileCreateImage=Uus rasterpilt
DialogFileCreateImageCtlCreate=Lisa rasterpilt
DialogFileCreateImageCtlCoordSystem=projektsioon:
DialogFileCreateImageCtlIndex=Loo ruumiindeks
DialogFileCreateImageCtlLevel=Tase:
DialogFileCreateImageCtlName=Nimi:
DialogFileCreateImageCtlQuery=Ava päringuna
DialogFileCreateImageCtlRect=Piirid:
DialogFileCreateImageCtlTable=Tugineb:
DialogFileCreateImageCtlTile=Tail:
DialogFileCreateImageCtlX=X:
DialogFileCreateImageCtlY=Y:
DialogFileCreateLabels=Uued märgised
DialogFileCreateLabelsCtlCoordSystem=projektsioon:
DialogFileCreateLabelsCtlCreate=Lisa märgised
DialogFileCreateLabelsCtlEditText=Muuda teksti...
DialogFileCreateLabelsCtlName=Nimi:
DialogFileCreateLabelsCtlQuery=Ava päringuna
DialogFileCreateLabelsCtlTable=Põhineb:
DialogFileCreateLabelsCtlText=Tekst:
DialogFileCreateLayout=Uus küljend
DialogFileCreateLayoutCtlCreate=Lisa küljend
DialogFileCreateLayoutCtlMargins=Lisa ääred
DialogFileCreateLayoutCtlName=Nimi:
DialogFileCreateLayoutCtlPaper=Formaat:
DialogFileCreateLayoutCtlQuery=Ava päringuna
DialogFileCreateLocation=Uus asukoht
DialogFileCreateLocationCtlCenterLat=Laiuskraad:
DialogFileCreateLocationCtlCenterLon=Pikkuskraad:
DialogFileCreateLocationCtlCreate=Lisa asukoht
DialogFileCreateLocationCtlName=Nimi:
DialogFileCreateLocationCtlQuery=Ava päringuna
DialogFileCreateLocationCtlScale=Mõõtkava:
DialogFileCreateLocationCtlWindow=Põhineb:
DialogFileCreateMap=Uus kaart
DialogFileCreateMapCtlBase=Aluskaart:
DialogFileCreateMapCtlCoordSystem=projektsioon:
DialogFileCreateMapCtlCreate=Lisa kaart
DialogFileCreateMapCtlName=Nimi:
DialogFileCreateMapCtlQuery=Ava päringuna
DialogFileCreateQuery=Uus SQL päring
DialogFileCreateQueryCtlCreate=Lisa päring
DialogFileCreateQueryCtlName=Nimi:
DialogFileCreateQueryCtlQuery=Ava päringuna
DialogFileCreateScript=Uus skript
DialogFileCreateScriptCtlCreate=Lisa skript
DialogFileCreateScriptCtlLanguage=Keel:
DialogFileCreateScriptCtlName=Nimi:
DialogFileCreateScriptCtlQuery=Ava päringuna
DialogFileCreateTable=Uus tabel
DialogFileCreateTableCtlCreate=Lisa tabel
DialogFileCreateTableCtlName=Nimi:
DialogFileCreateTableCtlQuery=Ava päringuna
DialogFileCreateTableCtlSchema=Muuda skeemi...
DialogFileExport=Ekspordi
DialogFileFolder=Vali
DialogFileImport=Impordi
DialogFileLink=Lingi
DialogFileLinkCtlCachePersistent=Puhverda
DialogFileOpen=Ava
DialogFileOpenCtlReadOnly=Ava kirjutuskaitstult
DialogFileOverwriteExport=Kinnita eksport
DialogFileOverwriteSave=Kinnita salvestamine
DialogFileOverwriteCtlOverwrite=Kirjuta üle:
DialogFileOverwriteCtlPrompt=Fail on juba olemas.
DialogFileOverwriteCtlRenameExport=Ekspordi nimega:
DialogFileOverwriteCtlRenameSave=Salvesta nimega:
DialogFileSave=Salvesta
DialogHelpAbout=Teave {productname} kohta
DialogHelpAboutCtlCheck=Kontrolli litsentsi
DialogHelpAboutCtlMachDelete=Eemalda
DialogHelpAboutCtlMachUpdate=Installi
DialogHelpAboutCtlOdbcDelete=Eemalda
DialogHelpAboutCtlOdbcUpdate=Installi
DialogHelpAboutCtlOdbcUpdateFix=Värskenda
DialogHelpAboutCtlSwitch=Vaheta litsentsi...
DialogHelpAboutCtlUpdateCheck=Kontrollin uuendusi...
DialogHelpAboutCtlUpdateNewF1=Saadaval uus versioon: {0}
DialogHelpAboutCtlUpdateNone=Uuendusi pole
DialogProgressCanceling=Katkestan toimingut...
DialogProgressCompleted=Toiming lõpetatud
DialogProgressElapsed=Aega kulunud:
DialogToolEditService=Teenus
DialogToolEditServiceCtlAddr=Aadress:
DialogToolEditServiceCtlAddrPostfix=(auto: peamine)
DialogToolEditServiceCtlArgs=Suvandid:
DialogToolEditServiceCtlName=Nimi:
DialogToolEditServiceCtlPathBinary=Täitmisfail:
DialogToolEditServiceCtlPathData=Andmed:
DialogToolEditServiceCtlPort=Port:
DialogToolEditServiceCtlPortPostfix=(auto: 9099)
DialogToolEditServiceCtlStart=Käivita:
DialogToolEditServices=Halda teenuseid
DialogToolEditServicesCtlReadOnly=Teenuste lisamiseks, eemaldamiseks ja seadistamiseks käivita käesolev programm administratori õigustes 
DialogToolEditUiStrings=Redigeeri tõlkefaili
DialogToolEditUiStringsCtlFile=Fail:
DialogToolEditUiStringsCtlSave=Salvesta
DialogToolEditUiStringsCtlSaveAll=Salvesta tõlkimata sõned kommentaaridena
DialogToolEditUiStringsFile=Vali fail
DialogToolEditUiStringsItem=Redigeeri tõlget
DialogToolEditUiStringsItemCtlName=Sõne:
DialogToolEditUiStringsItemCtlUseDef=Kasuta vaikimisi
DialogToolEditUiStringsItemCtlUseExisting=Kasuta olemasolevat
DialogToolEditUiStringsItemCtlUseMismatch=Kasuta vasteta
DialogToolEditUiStringsItemCtlValue=Tõlge:
DialogToolEditUiStringsItemCtlValueDef=Vaikimisi:
DialogToolOptions=Suvandid
DialogToolOptionsCtlColor=(värvide muutmiseks on vajalik taaskäivitus)
DialogToolOptionsCtlColorCached=Puhverdamise edenemine:
DialogToolOptionsCtlColorComputed=Eelvaade ja kuvamise edenemine:
DialogToolOptionsCtlColorInvalid=Sobimatu väärtus:
DialogToolOptionsCtlColorSelected=Valitud:
DialogToolOptionsCtlColorSelectedComputed=Valitud + eelvaade:
DialogToolOptionsCtlColorUnknown=Tundmatu väärtus:
DialogToolOptionsCtlConfirm=Kinnitused
DialogToolOptionsCtlConfirmDeleteEntities=Küsi kinnitust komponentide kustutamisel
DialogToolOptionsCtlConfirmDeleteRecords=Küsi kinnitust kirjete kustutamisel
DialogToolOptionsCtlConfirmDeleteSchemaItemsDependent=Küsi kinnitust sõltuvate elementide (kitsendus, väli, indeks) kustutamiseks
DialogToolOptionsCtlConfirmDropFilesChild=Küsi kinnitust alamandmelättesse failide tõstmisel
DialogToolOptionsCtlConfirmExit=Küsi kinnitust väljumisel
DialogToolOptionsCtlCoordSystemNew=Vaikimisi projektsioon uutele komponentidele
DialogToolOptionsCtlGraphics=Graafikarežiim
DialogToolOptionsCtlGraphicsEngine=Graafika:
DialogToolOptionsCtlGraphicsEngineAdvanced=Tavaline, ilma riistvarakiirenduseta
DialogToolOptionsCtlGraphicsEngineAdvancedHardware=Tavaline
DialogToolOptionsCtlGraphicsEngineBasic=Vähendatud
DialogToolOptionsCtlInterface=Kasutajaliides
DialogToolOptionsCtlInterfaceAccessKeys=Juurdepääsuklahvid:
DialogToolOptionsCtlInterfaceAccessKeysAuto=auto
DialogToolOptionsCtlInterfaceAccessKeysUseAlways=näita
DialogToolOptionsCtlInterfaceAccessKeysUseNever=peida
DialogToolOptionsCtlInterfaceLanguage=Keel (vajab taaskäivitust):
DialogToolOptionsCtlInterfaceLimitFetch=Vaikimisi näidatavate kirjete arv (väljaspoolt MAP-faili):
DialogToolOptionsCtlInterfaceWelcomeText=Näita tervitusteksti
DialogToolOptionsCtlSystem=Süsteem
DialogToolOptionsCtlSystemMemory=Mälukasutus, GB (vajab taaskäivitust):
DialogToolOptionsCtlTabColors=Värvid
DialogToolOptionsCtlTabGeneral=Üldine
DialogToolScanLas=Indekseeri LiDARifaile
DialogToolScanLasCtlFileInvalid=sobimatu
DialogToolScanLasCtlFileNeedIndex=indeksita
DialogToolScanLasCtlFileNeedMeta=metainfota
DialogToolScanLasCtlFolder=Andmete kaust:
DialogToolScanLasCtlScan=Indeks
DialogToolScanLasCtlThreads=Luba rööptöötlus
DialogToolScanLasFolder=Vali kaust
DialogToolScanRawBinary=Tuvasta binaarfail
DialogToolScanRawBinaryCtlChannels=Kanalid:
DialogToolScanRawBinaryCtlFile=Andmefail:
DialogToolScanRawBinaryCtlFileScan=Definitsioonifail:
DialogToolScanRawBinaryCtlNull=Puuduv väärtus:
DialogToolScanRawBinaryCtlSave=Salvesta
DialogToolScanRawBinaryCtlScan=Skanni
DialogToolScanRawBinaryCtlSize=Suurus:
DialogToolScanRawBinaryCtlSkip=Alusta baidist:
DialogToolScanRawBinaryCtlSkipPadding=Täidisbaidid:
DialogToolScanRawBinaryCtlType=Tüüp:
DialogToolScanRawBinaryFile=Vali fail
DialogToolScanRawText=Tuvasta tekstifail
DialogToolScanRawTextCtlChannels=Kanalid:
DialogToolScanRawTextCtlDelimiter=Eraldaja:
DialogToolScanRawTextCtlFile=Andmefail:
DialogToolScanRawTextCtlFileScan=Definitsioonifail:
DialogToolScanRawTextCtlNull=Puuduv väärtus:
DialogToolScanRawTextCtlSave=Salvesta
DialogToolScanRawTextCtlScan=Skanni
DialogToolScanRawTextCtlSize=Suurus:
DialogToolScanRawTextCtlSkip=Alusta reast:
DialogToolScanRawTextCtlType=Tüüp:
DialogToolScanRawTextFile=Vali fail
DialogViewLayers=Kihid
DialogViewLayersCreateFolder=Uus kaust
DialogViewMessages=Teated
DialogViewMessagesCtlCache=Loo ajutine indeks
DialogViewMessagesCtlCacheDrawing=Vektorjoonist ei saa kuvada, sest tabelil puudub ruumiindeks.
DialogViewMessagesCtlCacheImage=Rasterpilti ei saa kuvada, sest vahetasemete andmed on puudu.
DialogViewMessagesCtlCacheLabels=Märgiseid ei saa kuvada, sest tabelil puudub ruumiindeks.
DialogViewMessagesCtlDismiss=Unusta
DialogViewMessagesCtlRenderCache=Värskenda
DialogViewMessagesCtlRenderCacheImage=Rastri vahetasemete andmed pole värskendatud.
DialogViewProject=Projekt
DialogViewRecord=Info
DialogViewRecordCtlAddFrame=Add Frame
DialogViewRecordCtlAddRecord=Lisa kirje
DialogViewRecordCtlBackground=Taust:
DialogViewRecordCtlBorder=Ääris:
DialogViewRecordCtlCountFields=Välju:
DialogViewRecordCtlCountFrames=Paneele:
DialogViewRecordCtlCountFramesSelected=Valitud:
DialogViewRecordCtlCountLines=Ridu:
DialogViewRecordCtlCountRecords=Kirjeid:
DialogViewRecordCtlCountRecordsFetched=Kohale toodud:
DialogViewRecordCtlCountRecordsSelected=Valitud:
DialogViewRecordCtlCountRecordsShown=Kuvatud:
DialogViewRecordCtlDescription=Selgitus:
DialogViewRecordCtlEditFrame=Update Frame
DialogViewRecordCtlEditRecord=Muuda kirje
DialogViewRecordCtlGrid=Grid
DialogViewRecordCtlImageSize=Rastri suurus:
DialogViewRecordCtlLanguage=Keel:
DialogViewRecordCtlLegend=Legend:
DialogViewRecordCtlNorthArrow=North arrow:
DialogViewRecordCtlPadding=Täidis:
DialogViewRecordCtlPageSize=Lehekülje suurus:
DialogViewRecordCtlPixelSize=Piksli suurus:
DialogViewRecordCtlRectAuto=Auto
DialogViewRecordCtlRectMax=Parem / ülemine
DialogViewRecordCtlRectMin=Vasak / alumine
DialogViewRecordCtlRectSize=Suurus
DialogViewRecordCtlRectUnit=Ühikud:
DialogViewRecordCtlRectX=X:
DialogViewRecordCtlRectY=Y:
DialogViewRecordCtlSampleMetric=Näidiskujund:
DialogViewRecordCtlSampleText=Näidistekst:
DialogViewRecordCtlSampleWidth=Näidis laius / asend:
DialogViewRecordCtlScaleBar=Scale bar:
DialogViewRecordCtlTabCoords=Käänupunktid
DialogViewRecordCtlTabEntity=Komponent
DialogViewRecordCtlTabPixels=Pikslid
DialogViewRecordCtlTabPosition=Positsioon
DialogViewRecordCtlTabStyle=Stiil
DialogViewRecordCtlTabValues=Väärtused
DialogViewRecordCtlTabValuesJoin=Seotud
DialogViewRegister=Koordinaatimine
DialogViewRegisterCtlDiv=Piksli jaotisi:
DialogViewRegisterCtlErrorTotal=Koguviga (RMS):
DialogViewRegisterCtlLayer=Koordinaatimine:
DialogViewRegisterCtlPreview=Eelvaade
DialogViewRegisterCtlQuery=Ava päringuna
DialogViewRegisterCtlRegister=Koordinaatimine
DialogViewRegisterCtlRender=Renderda:
DialogViewRegisterCtlWarp=Meetod:
DialogViewSelect=Valimine
DialogViewSelectCtlEditExpression=Muuda avaldist...
DialogViewSelectCtlPick=Muuda parameetreid
DialogViewSelectCtlPreview=Eelvaade
DialogViewSelectCtlQuery=Ava päringuna
DialogViewSelectCtlSelect=Vali
DialogViewSelectCtlTabExpression=Avaldis
DialogViewSelectCtlTabPersistent=Salvestatud valikud
DialogViewSelectCtlTabTemplate=Mallid
DialogViewSelectCtlThreads=Luba rööptöötlus
DialogViewSnap=Snäppimise seaded
DialogViewSnapCtlBearingDiv=Asimuudi jaotisi:
DialogViewStyle=Stiilid
DialogViewStyleCtlBreaks=Vahemikke:
DialogViewStyleCtlEditStyle=Muuda stiili
DialogViewStyleCtlEditText=Redigeeri teksti...
DialogViewStyleCtlFill=Vahepealsed:
DialogViewStyleCtlOverrides=Individuaalne stiil
DialogViewStyleCtlOverridesSchema=Skeem...
DialogViewStyleCtlShade=Kasuta reljeefivarjutust
DialogViewStyleCtlShadeScaleZ=Vertikaalskaala:
DialogViewStyleCtlShadeSun=Asimuut:
DialogViewStyleCtlShadeSunAltitude=Tõusunurk:
DialogViewStyleCtlShadeUnused=Reljeefivarjutus põhineb ainult ühel kanalil.
DialogViewStyleCtlTabEntityDrawing=Vektorjoonis
DialogViewStyleCtlTabEntityImage=Rasterpilt
DialogViewStyleCtlTabEntityLabels=Märgised
DialogViewStyleCtlTabOptions=Valikud
DialogViewStyleCtlTally=Sobita
DialogViewStyleCtlValues=Väärtusi:
DialogViewTransform=Teisendused
DialogViewTransformCtlAddEntity=Lisa komponent
DialogViewTransformCtlEditField=Muuda välja
DialogViewTransformCtlOptions=Valikud...
DialogViewTransformCtlPick=Muuda parameetreid
DialogViewTransformCtlPreview=Eelvaade
DialogViewTransformCtlQuery=Ava päringuna
DialogViewTransformCtlSelectionOnly=Muuda ainult valitud kirjeid
DialogViewTransformCtlTabExpression=Avaldis
DialogViewTransformCtlTabTemplate=Mallid
DialogViewTransformCtlThreads=Luba rööptöötlus
DialogViewTransformCtlTransform=Teisenda
DialogViewTraverseOpts=Käigu parameetrid
DialogViewTraverseOptsCtlDirType=Suuna tüüp:
DialogViewTraverseOptsCtlDirTypeNorth=North azimuth
DialogViewTraverseOptsCtlDirTypePolar=Polar
DialogViewTraverseOptsCtlDirTypeQuadrant=Quadrant bearing
DialogViewTraverseOptsCtlDirTypeSouth=South azimuth
DialogViewTraverseOptsCtlDirUnit=Suuna ühik:
DialogViewTraverseOptsCtlDirUnitDecimal=Kraad
DialogViewTraverseOptsCtlDirUnitDegMinSec=Kraad-minut-sekund
DialogViewTraverseOptsCtlDirUnitGradian=Goon
DialogViewTraverseOptsCtlDirUnitRadian=Radiaan
DialogWindowWindows=Aknad
DialogWindowWindowsCtlSwitch=Aktiveeri aken

# <error>
ErrorCanceled=Toiming katkestati.
ErrorCollateInvalid=Sobimatu sorteerimisalus.
ErrorCollateSelect=Sorteerimisalus valimata.
ErrorConstraintCantAdd=Kitsendust ei saa lisada.
ErrorConstraintCantAddF1=Kitsendust ei saa lisada '{0}'
ErrorConstraintInvalid=Sobimatu kitsendus.
ErrorConstraintInvalidF1=Sobimatu kitsendus '{0}'.
ErrorCommandCantRun=Käsku ei saa käivitada.
ErrorCommandInvalid=Sobimatu käsk.
ErrorCompressionCantCompress=Andmeid ei saa kokku pakkida.
ErrorCompressionCantUncompress=Andmeid ei saa lahti pakkida.
ErrorCompressionInvalid=Sobimatu pakkimisalgoritm.
ErrorCoordAxesInvalid=Sobimatud teljed.
ErrorCoordBaseSelect=Daatum valimata.
ErrorCoordConverterInvalid=Koordinaatsüsteemi või teisendusraja initsialiseerimine nurjus.
ErrorCoordPathInvalid=Sobimatu koordinaatide teisenduste jada.
ErrorCoordPathMissing=Koordinaatide teisenduste jada puudub.
ErrorCoordSystemInvalid=Sobimatu projektsioon.
ErrorCoordSystemSelect=projektsioon valimata.
ErrorCoordTransformInvalid=Sobimatu koordinaaditeisendus.
ErrorCoordUnitSelect=projektsiooni ühikud valimata.
ErrorDataBufferInvalid=Sobimatu andmepuhver.
ErrorDataBufferSizeInvalid=Sobimatu andmepuhvri suurus.
ErrorDataCantLoad=Andmete laadimine nurjus.
ErrorDataCantRead=Andmete lugemine nurjus.
ErrorDataCantWrite=Andmete kirjutamine nurjus.
ErrorDataCantWriteInvalid=Kirjutamine nurjus, võimaliku rikke tõttu on kirjutamine keelatud.
ErrorDatabaseCantAutogenerateFields=Andmebaas ei luba automaattäidetavaid välju.
ErrorDatabaseCantConnect=Andmebaasiühendust ei saa luua.
ErrorDatabaseCantCreate=Andmebaasi ei saa luua.
ErrorDatabaseCantDropFiles=Andmebaas on kirjutuskaitstud.
ErrorDatabaseCantDropFilesChild=Andmeläte on avamata või kirjutuskaitstud.
ErrorDatabaseCantUseRTreeGeom=Andmebaas ei luba luua ruumikujudele indeksit.
ErrorDatabaseCantUseRTreeTile=Andmebaas ei luba luua tailidele indeksit.
ErrorDatabaseDisconnected=Andmebaasi ühendus on katkenud.
ErrorDatabaseInvalid=Sobimatu andmebaas.
ErrorDatabaseShutdown=Andmebaas on välja lülitunud.
ErrorEntityCantAdd=Komponendi lisamine nurjus.
ErrorEntityCantAddLink=Püsivasse baasi ei saa lisada ajutise baasi komponenti.
ErrorEntityCantDelete=Komponendi kustutamine nurjus.
ErrorEntityCantDeleteSystem=Süsteemikomponenti ei saa kustutada.
ErrorEntityCantDesign=Komponendi skeemi muutmine nurjus.
ErrorEntityCantDesignSystem=Süsteemikomponenti skeemi ei saa muuta.
ErrorEntityCantRename=Ümbernimetamine nurjus.
ErrorEntityCantRenameSystem=Süsteemikomponenti ei saa ümber nimetada.
ErrorEntityInvalid=Komponent puudub või on sobimatu.
ErrorEntitySelect=Komponent valimata.
ErrorEntityTypeInvalid=Sobimatu komponenditüüp.
ErrorEventCantCreate=Süsteemisündmuse objekti loomine nurjus.
ErrorEventCantWait=Sünkronisatsioonitõrge.
ErrorExpressionAggregate=Ootamatu agregaator-funktsioon.
ErrorExpressionBlank=Avaldis ei või olla tühi.
ErrorExpressionCantParse=Avaldise parsimine nurjus.
ErrorExpressionCantParseOwnedF1=Välja '{0}' avaldise parsimine nurjus.
ErrorExpressionExpectAggregate=Avaldiseks peab olema agregaator-funktsioon.
ErrorExpressionExpectBoolean=Avaldis peab tagastama tõeväärtuse.
ErrorExpressionExpectField=Avaldis peab olema väli.
ErrorExpressionExpectSingle=Avaldis peab tagastama skaalari.
ErrorExpressionExpectString=Avaldis peab tagastama Sõne.
ErrorExpressionExpectTable=Avaldis peab tagastama tabeli.
ErrorExpressionExpectTableSingle=Avaldis peab tagastama tabeli, millel on üks väli.
ErrorExpressionFieldDuplicateOrder=Välja on ORDER BY lauses mainitud korduvalt.
ErrorExpressionFieldUnaggregated=Väli peab olema osa GROUP BY või agregaator-funktsiooni argumendiks.
ErrorExpressionFieldUnaggregatedNested=Väli peab olema osa GROUP BY või agregaator-funktsiooni argumendiks välimises SELECT-lauses.
ErrorExpressionOptionConflict=Suvand on mõne teisega konfliktis.
ErrorExpressionOptionInvalid=Sobimatu suvand.
ErrorExpressionTypeMismatch=Avaldise tüüp ei klapi.
ErrorFieldCantAdd=Välja lisamine nurjus.
ErrorFieldCantDelete=Välja kustutamine nurjus.
ErrorFieldCantDeleteIdentity=Ainumääratlusvälja kustutamine nurjus.
ErrorFieldCantDeleteRefConstraintF2=Välja '{0}' kustutamine nurjus, kitsendus '{1}' viitab sellele.
ErrorFieldCantDeleteRefFieldF2=Välja '{0}' kustutamine nurjus, arvutatud väli '{1}' viitab sellele.
ErrorFieldCantDeleteRefIndexF2=Välja '{0}' kustutamine nurjus, indeks '{1}' viitab sellele.
ErrorFieldCantDeleteTwice=Välja ei saa kustutada topelt.
ErrorFieldCantRename=Välja ümbernimetamine nurjus.
ErrorFieldCantRenameRefConstraintF2=Välja '{0}' ümbernimetamine nurjus, kitsendus '{1}' viitab sellele.
ErrorFieldCantRenameRefFieldF2=Välja '{0}' ümbernimetamine nurjus, arvutatud väli '{1}' viitab sellele.
ErrorFieldCantRenameRefIndexF2=Välja '{0}' ümbernimetamine nurjus, indeks '{1}' viitab sellele.
ErrorFieldCantRenameIdentity=Ainumääratlusvälja ei saa ümbernimetada.
ErrorFieldCantRenameIdentityF1=Ainumääratlusvälja '{0}' ei saa ümbernimetada.
ErrorFieldCantSet=Väljale ei sa väärtust omistada.
ErrorFieldCantSetAutogenerated=Automaattäidetavasse välja ei saa kirjutada.
ErrorFieldCantSetComputed=Arvutatud väljale ei sa väärtust omistada.
ErrorFieldCantSetComputedF1=Arvutatud väljale '{0}' ei sa väärtust omistada.
ErrorFieldCantSetF1=Väljale '{0}' ei sa väärtust omistada.
ErrorFieldCantSetForeign=Teise tabeli indeksi alusel ei saa seda välja muuta.
ErrorFieldCantSetIdentity=Ainumääratlusväljale ei saa väärtust omistada.
ErrorFieldCantSetKey=Võtmeväljale ei saa väärtust omistada.
ErrorFieldCantSetMultiple=Korraga rohkem kui ühe tabeli välju ei saa muuta.
ErrorFieldCantSetRefConstraintF1=Välja(de)le ei sa väärtust omistada, rikuvad kitsendust '{0}'.
ErrorFieldCantSetRefIndexF1=Välja(de)le ei sa väärtust omistada, indeks '{0}' keelab.
ErrorFieldInvalid=Sobimatu väli.
ErrorFieldInvalidF1=Sobimatu väli '{0}'.
ErrorFieldUnindexedRTreeTile=Ruumiindeks peab sisaldama tailivälja.
ErrorFileCantClose=Faili sulgemine nurjus.
ErrorFileCantCloseLocked=Faili sulgemine nurjus, 'file page' on lukus.
ErrorFileCantCreate=Faili loomine nurjus.
ErrorFileCantCreateTemp=Ajutise faili loomine nurjus.
ErrorFileCantGetSize=Faili suuruse leidmine nurjus.
ErrorFileCantOpen=Faili avamine nurjus.
ErrorFileCantSave=Faili salvestamine nurjus.
ErrorFileCantSaveLocked=Faili salvestamine nurjus, 'file page' on lukus.
ErrorFileCantSeek=Failipositsiooni otsing nurjus.
ErrorFileCantSetSize=Faili suuruse seadmine nurjus.
ErrorFileDataInvalid=Sobimatu failiformaat.
ErrorFileIncompleteSave=Fail on ebatäielik, viimast salvestust ei lõpetatud.
ErrorFileInvalid=Sobimatu fail.
ErrorFilePositionInvalid=Sobimatu faili positioon.
ErrorFileReadOnly=Fail on kirjutuskaitstud.
ErrorFileSizeInvalid=Sobimatu faili suurus.
ErrorFileTypeInvalid=Sobimatu faili tüüp.
ErrorFileTypeUnknown=Tundmatu faili tüüp.
ErrorFileVersionInvalid=Sobimatu faili versioon.
ErrorFunctionParameterCountMismatch=Funktsiooni argumentide arv vale.
ErrorFunctionUnknown=Tundmatu funktsioon.
ErrorGeomDataInvalid=Sobimatu ruumikuju.
ErrorGeomGlueInvalid=Sobimatu kõverjoonega objekt.
ErrorGeomGlueNurbsInvalid=Sobimatu splaini väärtus.
ErrorGeomTypeInvalid=Sobimatu ruumikujutüüp.
ErrorGridSizeInvalid=Sobimatu ruutvõrgu suurus.
ErrorGridSizeTooLarge=Ruutvõrgu maht liiga suur.
ErrorHeapCantDeleteDefault=Vaikimisi pinu ei saa tühjendada.
ErrorHeapInvalid=Sobimatu pinu.
ErrorImagePositionInvalid=Sobimatu positsioon rastris.
ErrorImageSizeInvalid=Sobimatu rastri suurus.
ErrorImageSizeTooLarge=Raster on liiga suur.
ErrorIncludeRecursive=Rekursioon $include$ lausetes.
ErrorIndexCantAdd=Indeksi lisamine nurjus.
ErrorIndexCantAddDuplicate=Indeksit ei saa lisada topelt.
ErrorIndexCantAddF1=Indeksi lisamine nurjus '{0}'.
ErrorIndexCantDelete=Indeksi kustutamine nurjus.
ErrorIndexCantRename=Indeksi ümbernimetamine nurjus.
ErrorIndexCantRenameIdentity=Ainumääratlusindeksi ümbernimetamine nurjus.
ErrorIndexCantRenameIdentityF1=Ainumääratlusindeksit ei saa ümbernimetada '{0}'.
ErrorIndexInvalid=Sobimatu indeks.
ErrorIndexInvalidF1=Sobimatu indeks '{0}'.
ErrorIndexKeyAbsent=Võtmeväli puudub.
ErrorIndexKeyComposite=Rohkem kui üks võtmeväli.
ErrorIndexKeyDuplicate=Võtmeväli on korduvalt mainitud.
ErrorIndexKeyOptsInvalid=Sobimatud võtmevälja valikud.
ErrorIndexKeyTypeInvalid=Sobimatu võtmevälja tüüp.
ErrorIndexKeyValueDuplicate=Duplikaat võtmeväljas.
ErrorIndexKeyValueInvalid=Võtmeväljas sobimatu väärtus.
ErrorIndexKeyValueInvalidF1=Võtmeväljas sobimatu väärtus '{0}'.
ErrorIndexKeyValueNull=Võtmeväljas pole puuduvad väärtused (NULL) lubatud.
ErrorIndexKeyValueNullF1=Võtmeväljas '{0}' pole puuduvad väärtused (NULL) lubatud.
ErrorIndexKeyValueSizeInvalid=Võtmeväljas sobimatu suurusega väärtus.
ErrorIndexKeyValueSizeInvalidF1=Võtmeväljas sobimatu suurusega väärtus '{0}'.
ErrorIndexTypeInvalid=Sobimatu indeksi tüüp.
ErrorIndexTypeInvalidRemoteOnly=Indeksi tüüp on toetatud ainult välistes andmebaasides.
ErrorInternal=Sisemine tõrge.
ErrorInternalUntyped=Tundmatu sisemine tõrge.
ErrorItemCantAlloc=Mälu ei saa eraldada, liiga palju väärtusi.
ErrorItemCountInvalid=Sobimatu väärtuste arv.
ErrorItemCountTooLarge=Liiga mitu väärtust.
ErrorItemInvalid=Sobimatu andmeelement.
ErrorItemSizeInvalid=Väärtusel sobimatu pikkus.
ErrorItemSizeMismatch=Väärtusel vale pikkus.
ErrorItemSizeTooLarge=Väärtus liiga suur.
ErrorJoinBlank=Pole andmeid, mida ühendada.
ErrorJoinCantPrepare=Andmete ettevalmistamine ühendamiseks nurjus.
ErrorLanguageSelect=Keel valimata.
ErrorLexerPositionInvalid=Lekser kaotas järje.
ErrorLicenseFeature=Käesolev litsents ei anna selleks õigusi.
ErrorLoginBlank=Kasutajatunnus ei või olla tühi.
ErrorMachCantDelete=Pole piisavalt õigusi, et süsteemiülest litsentsi eemaldada.
ErrorMachCantUpdate=Pole piisavalt õigusi, et süsteemiülest litsentsi paigaldada.
ErrorMergeBlank=Pole ühtegi komponenti, mida mestida.
ErrorNameAmbiguous=Nimi pole üheselt mõistetav.
ErrorNameBlank=Nimi ei või olla tühi.
ErrorNameDuplicate=Nimi on juba kasutusel.
ErrorNameDuplicateF1=Nimi '{0}' on juba kasutusel.
ErrorNameInvalid=Sobimatu nimi.
ErrorNameTableNoSpaces=Tabelinimes ei tohi olla tühikuid.
ErrorNameUnknown=Tundmatu nimi.
ErrorOdbcCantDelete=ODBC draiveri desinstallimine nurjus, ebapiisavad õigused.
ErrorOdbcCantUpdate=ODBC draiveri installimine nurjus, ebapiisavad õigused.
ErrorPageCantAlloc=Mälulehe eraldamine nurjus, mälu otsas.
ErrorPageCantFreeFreed=Mälulehe vabastamine nurjus, mäluleht on eraldamata.
ErrorPageCantFreeLocked=Mälulehe vabastamine nurjus, mäluleht on lukus.
ErrorPageCantLockAlloc=Mälulehe lukustamine nurjus, mälu otsas.
ErrorPageCantLockCacheFull=Mälulehe lukustamine nurjus, puhvermälu on otsas.
ErrorPageCantLockFreed=Mälulehe lukustamine nurjus, mäluleht on eraldamata.
ErrorPageInvalid=Sobimatu mälulehe viit.
ErrorPageMarginsInvalid=Sobimatud lehe ääred.
ErrorPageMarginsTooLarge=Lehe ääred liiga suured.
ErrorPageSizeInvalid=Sobimatu lehe formaat.
ErrorPasswordMismatch=Paroolid ei klapi.
ErrorPathInvalid=Sobimatu rada.
ErrorPointerInvalid=Viidatud komponenti pole.
ErrorPreviewTableBinary=Eelvaade puudub, binaarväärtused.
ErrorPreviewTableGeom=Eelvaade puudub, ruumikujud. Ava kaardiaken.
ErrorPreviewTableTile=Eelvaade puudub, pikslid. Ava kaardiaken.
ErrorPrintCantEnd=Ei suuda lõpetada printimistööd.
ErrorPrintCantEndPage=Ei suuda lõpetada lehekülje printimist.
ErrorPrintCantStart=Ei suuda alustada printimistööd.
ErrorPrintCantStartPage=Ei suuda alustada lehekülje printimist.
ErrorQueryCantParse=Päringu parsimine nurjus.
ErrorQueryCantParseParameters=Päringu parameetrite parsimine nurjus.
ErrorQueryCantPopPragmas=Pragmade taastamine nurjus, pragmade pinu on tühi.
ErrorQueryInvalid=Päringu struktuur on sobimatu.
ErrorQueryInvalidEmpty=Päring peab sisaldama üht või mitut käsku.
ErrorQueryRecursive=Rekursioon päringute järgnevuses.
ErrorRecordCantAdd=Kirje lisamine nurjus.
ErrorRecordCantAddRefConstraintF1=Kirje lisamine nurjus, rikub kitsendust '{0}'.
ErrorRecordCantAddRefIndexF1=Kirje lisamine nurjus, indeks '{0}' ei luba.
ErrorRecordCantDelete=Kirje kustutamine nurjus.
ErrorRecordCantSelectAny=Kirjete valimine nurjus.
ErrorRecordInvalid=Sobimatu kirje.
ErrorRectInvalid=Sobimatu ristkülik.
ErrorSchemaBlankExport=Sobilikke välju pole.
ErrorSchemaBlankPaste=Pole ühtki välja, mida kleepida.
ErrorSchemaCantChange=Tabeli skeemi muutmine nurjus.
ErrorSchemaCantIdentify=Tabelil peab olema unikaalne indeks.
ErrorSchemaCantIdentifyTransform=Tabelil peab olema unikaalne indeks ilma binaarväljadeta.
ErrorSchemaCantRename=Välja, indeksi või kitsenduse nimie ei saa muuta.
ErrorSchemaFieldCountMismatch=Tabelid peavad sisaldama sama arvu välju.
ErrorSchemaInvalid=Sobimatu tabeliskeem.
ErrorScriptCantCompile=Skripti kompileerimine nurjus.
ErrorScriptCantRun=Skripti ei saa käivitada.
ErrorScriptCantRunEntry=Skripti ei saa käivitada, puudub sisendpunkt (Main).
ErrorScriptEngineCantCreate=Skriptimootori laadimine nurjus.
ErrorScriptEngineCantCreateContext=Skriptimootori konteksti loomine nurjus.
ErrorScriptEngineCantCreateMissing=Skriptimootor on installimata.
ErrorScriptEngineCantStart=Skriptimootori initsialiseerimine nurjus.
ErrorScriptEngineInvalid=Sobimatu skriptimootor.
ErrorScriptEngineNonInteractive=Skriptimootor ei toeta interaktiivser režiimi.
ErrorScriptGeneric=Viga skripti käimisel.
ErrorScriptObjectDisposed=Objekt on likvideeritud.
ErrorScriptObjectExpected=Väärtus pole obkekt.
ErrorScriptObjectTypeInvalid=Sobimatu objektitüüp.
ErrorScriptSchemaInvalid=Ei suuda tuvastada skriptifunktsiooni tagastatud tabeli skeemi.
ErrorSequenceInvalid=Sobimatu kirjete jada.
ErrorServerAlreadyRunning=Üks serveri eksemplar juba käib.
ErrorServerBlank=Server ei tohi olla tühi.
ErrorServerCantAuthenticate=Autentimine nurjus.
ErrorServerCantConnect=Ühenduse loomine serveriga nurjus.
ErrorServerCantGetData=Andmeid ei saa kätte.
ErrorServerCantInitialize=Serverit ei saa käivitada.
ErrorServerContentTypeMismatch=Serveri sisu ei klapi.
ErrorServerRequestInvalid=Sobimatu päring serverisse.
ErrorServerVersionInvalid=Protokolli versioon pole toetatud.
ErrorServiceAddrInvalid=Sobimatu võrguaadress.
ErrorServiceBinaryInvalid=Teenuse täitmisfaili ei leita.
ErrorServiceCantAdd=Teenuse lisamine nurjus.
ErrorServiceCantChange=Teenuse seadistuse muutmine nurjus.
ErrorServiceCantDelete=Teenuse eemaldamine nurjus.
ErrorServiceCantStart=Teenuse käivitamine nurjus.
ErrorServiceCantStop=Teenuse peatamine nurjus.
ErrorServiceDataInvalid=Teenus ei leia andmefaili.
ErrorServiceNameInvalid=Sobimatu teenuse nimi.
ErrorServicePortInvalid=Sobimatu võrgu port.
ErrorSessionInvalid=Sobimatu seanss.
ErrorSocketCantAccept=Ühenduskatse nurjus.
ErrorSocketCantBind=Selle võrguliidese kaudu ei saa ühendusi kuulata.
ErrorSocketCantConfigure=Võrguühenduse seadistamine nurjus.
ErrorSocketCantCreate=Võrguühenduse algatamine nurjus.
ErrorSocketCantInitialize=Võrguteenuste algatamine nurjus.
ErrorSocketCantListen=Võrguühenduste kuulamine nurjus.
ErrorSocketCantSendReceive=Võrguühendus ei võimalda andmete vastuvõttu ega edastust.
ErrorSocketDisconnected=Võrguühendus suletud.
ErrorSocketInterfaceInvalid=Sobimatu võrguliides.
ErrorSourceBlank=Aadress ei tohi olla tühi.
ErrorSourceLibraryMaskInvalidExt=Sobimatu lätte mask, näita faililaiend või '*'.
ErrorSourceLibraryMaskInvalidX=Sobimatu lätte mask, X puudu.
ErrorSourceLibraryMaskInvalidY=Sobimatu lätte mask, Y puudu.
ErrorStreamCantSetSize=Voo suuruse seadmine nurjus.
ErrorStreamPositionInvalid=Sobimatu voo positsioon.
ErrorStreamSizeInvalid=Sobimatu voo suurus.
ErrorStreamSizeTooLarge=Sobimatu voo suurus (ületab mälusegmendi mahtu).
ErrorStringCantFormat=Sõnumi vormindamine nurjus.
ErrorStyleChoicesBlank=Valik tegemata.
ErrorTableInvalid=Sobimatu tabel.
ErrorTechCantExport=Soovitud formaati ei saa eksportida.
ErrorTechInvalid=Sobimatu formaat.
ErrorThreadCantCreate=Lõime loomine nurjus.
ErrorThreadInvalid=Sobimatu lõim.
ErrorTileReduceInvalid=Sobimatu taili vähendusmeetod.
ErrorTileSizeInvalid=Sobimatu taili suurus.
ErrorTileSizeTooLarge=Liiga suur tailisuurus.
ErrorTileTypeInvalid=Sobimatu tailitüüp.
ErrorToleranceInvalid=Sobimatu tolerants.
ErrorTraceAreasTooMany=Liiga palju alasid, mida vektoriseerida.
ErrorTransactionCantBegin=Transaktsiooni alustamine nurjus.
ErrorTransactionCantEnd=Transaktsiooni lõpetamine nurjus.
ErrorTransactionGeneric=Transaktsioon nurjus.
ErrorTypeCantConvert=Tüübiteisendus nurjus.
ErrorTypeInvalid=Sobimatu tüüp.
ErrorTypeMismatch=Tüübilahknevus.
ErrorTypeLibCantLoad=Teegi laadimine nurjus.
ErrorUuidCantCreate=UUID genereerimine nurjus.
ErrorValueInvalid=Sobimatu väärtus.
ErrorValueNull=Sobimatu väärtus, NULL pole lubatud.
ErrorValueTooLarge=Liiga suur väärtus.
ErrorWebCantGetResource=Veebiressursi hankimine nurjus.
ErrorWebCantPostResource=Andmete saatmine veebiressursile nurjus.
ErrorWebRequestInvalid=Sobimatu veebipäring.
ErrorWorkerCantCreate=Töölõime loomine nurjus.
ErrorWorkerCantCreateShutdown=Töölõime loomine nurjus, sulgumine.
ErrorWorkerFuncInvalid=Sobimatu töölõime funktsioon.
ErrorWorkerGeneric=Toiming nurjus.
ErrorWorkerInvalid=Sobimatu töölõim.

# <key>
KeyAdd=Plus
KeyBackspace=Back
KeyDelete=Delete
KeyDivide=Slash
KeyDown=Down
KeyEnd=End
KeyEnter=Enter
KeyEscape=Escape
KeyFunctionF1=F{0}
KeyHome=Home
KeyInsert=Insert
KeyLeft=Left
KeyMultiply=Mul
KeyPageDown=PgDn
KeyPageUp=PgUp
KeyQuestion=Question
KeyRight=Right
KeySpace=Space
KeySubtract=Minus
KeyTab=Tab
KeyTilde=ü
KeyUp=Up

# <key modifier>
KeyModifierAlt=Alt+
KeyModifierControl=Ctrl+
KeyModifierShift=Shift+

# <name>
NameFolderSystemData=!Süsteemiandmed
NameFolderSystemDataCache=!Süsteemiandmed\Puhver
NameNewComment=Märkmed
NameNewConstraint=Kitsendus
NameNewCoordBase=Daatum
NameNewCoordSystem=projektsioon
NameNewDataSource=Andmeläte
NameNewDrawing=Vektorjoonis
NameNewDrawingRegister=Ankurpunktid
NameNewField=Väli
NameNewFieldGeometry=Geom
NameNewFieldStyle=Stiil
NameNewFieldText=Märgis
NameNewFieldTile=Tile
NameNewFieldX=X
NameNewFieldY=Y
NameNewFolder=Kaust
NameNewImage=Pilt
NameNewIndex=Indeks
NameNewLabels=Märgis
NameNewLayout=Küljend
NameNewLocation=Asukoht
NameNewMap=Kaart
NameNewQuery=Päring
NameNewScript=Skript
NameNewTable=Tabel

# <progress>
ProgressCachingData=Andmete puhverdamine
ProgressCopyingData=Andmete kopeerimine
ProgressDeletingData=Andmete kustutamine
ProgressLineF1=Rida {0}
ProgressNodeF1=Sõlm {0}
ProgressPastingData=Andmete kleepimine
ProgressPrintEnding=Printimise lõpetamine
ProgressPrintStarting=Printimise alustamine
ProgressPrintingData=Printimine
ProgressProcessingData=Andmete töötlemine
ProgressQueryAlter=Komponendi muutmine
ProgressQueryAny=Andmete töötlemine
ProgressQueryCreate=Komponendi loomine
ProgressQueryDelete=Kirjete kustutamine
ProgressQueryDrop=Komponendi kustutamine
ProgressQueryInsert=Kirjete lisamine
ProgressQueryRename=Komponendi ümbernimetamine
ProgressQueryUpdate=Kirjete muutmine
ProgressReadingData=Andmete lugemine
ProgressRecordF1=Kirje {0}
ProgressSavingData=Andmete salvestamine
ProgressScanningData=Andmete skannimine
ProgressSortingData=Andmete sortimine
ProgressUncompressingData=Andmete lahti pakkimine
ProgressWritingData=Andmete kirjutamine

# <progress caption>
ProgressCaptionConnectingData=Andmelättega ühendumine
ProgressCaptionCopyingData=Andmete kopeerimine
ProgressCaptionDeletingData=Andmete kustutamine
ProgressCaptionDesigningData=Andmete ümberkorraldamine
ProgressCaptionExportingData=Andmete eksportimine
ProgressCaptionImportingData=Andmete importimine
ProgressCaptionIndexingData=Andmete indekseerimine
ProgressCaptionLinkingData=Andmete linkimine
ProgressCaptionMergingData=Andmete mestimine
ProgressCaptionMigratingData=Andmete siirdamine
ProgressCaptionPastingData=Andmete kleepimine
ProgressCaptionPreviewingData=Eelvaate arvutamine
ProgressCaptionPrintingData=Andmete printimine
ProgressCaptionProjectingData=Andmete projektsooni muutmine
ProgressCaptionReadingData=Andmete lugemine
ProgressCaptionRegisteringData=Koordinaatimine
ProgressCaptionRunningCommand=Käsu jooksutamine
ProgressCaptionRunningQuery=Päringu jooksutamine
ProgressCaptionRunningScript=Skripti jooksutamine
ProgressCaptionSavingData=Andmete salvestamine
ProgressCaptionScanningData=Andmete skannimine
ProgressCaptionSearchingData=Andmete otsimine
ProgressCaptionSelectingData=Andmete valimine
ProgressCaptionSortingData=Andmete sortimine
ProgressCaptionTransformingData=Andmete teisendamine
ProgressCaptionUpdatingData=Andmete uuendamine
ProgressCaptionWritingData=Andmete kirjutamine

# <question>
QuestionActionCancel=Katkesta toiming?
QuestionApplicationExit=Välju rakendusest?
QuestionDataSave=Salvesta muudatused?
QuestionDatabaseDropFiles=Tõsta failid alamlättesse?
QuestionDatabaseSave=Salvesta muudatused?
QuestionDatabaseSaveChildren=Salvesta alam-andmelätte muudatused?
QuestionEntityDeleteSelected=Kustuta valitud komponendid?
QuestionRecordDeleteSelected=Kustuta valitud kirjed?
QuestionRecordDeleteSelectedLayout=Kustuta valitud raamid?
QuestionSchemaItemDeleteDependent=Kustuta kitsendused, väljad ja indeksid, mis sõltuvad valitud väljadest?
QuestionScriptInterrupt=Katkesta skript?

# <report>
ReportAddinScanF1=Lisandmooduleid leitud: {0}
ReportCacheRebuild=Puhver on rikkis, korrastan.
ReportCacheRebuildOutdated=Puhver on vananenud, uuendan.
ReportCacheUseTemporary=Puhvrile pole kirjutusõigust, kasutan ajutist puhver-faili.
ReportCommandFullFetch=Täieliku laadimise (fullfetch) sisse/välja-lülitamine jõudlustestiks.
ReportCommandModeManifold=Kasuta Manifoldi süntaksit.
ReportCommandModeNative=Kasuta andmelätte-spetsiifilist süntaksit (vaikimisi).
ReportCommandPrint=Väärtusta avaldis ja näita tulemust.
ReportCopyF1=Kopeerimine: {0}
ReportEndOfFile=Faili lõpp.
ReportEndOfFileLinesValuesF2=Faili lõpp, {0} rida, {1} väärtus(t) lisaks.
ReportEndOfLineValuesF1=Rea lõpp, {0} väärtus(t).
ReportFetchWebF1=Veebipäring: {0}
ReportFileCloseF1=Suletud: {0}
ReportFileCreateF1=Loodud: {0}
ReportFileCreateCacheF1=Puhvri loomine: {0}
ReportFileExportF1=Eksporditud: {0}
ReportFileImportF1=Imporditud: {0}
ReportFileLinkF1=Linkimine: {0}
ReportFileOpenF1=Avatud: {0}
ReportFileSaveF1=Salvestatud: {0}
ReportFileSaveCacheF1=Salvesta puhver: {0}
ReportFramesSelectedF2=Valitud: {1} {0}-st
ReportGridLoadErrorF1=Ruutvõrgu laadimine nurjus: {0}
ReportIndexInvalid=Indeksis on vastuolu, kirjutamine on keelatud.
ReportIndexInvalidCollate=Indeks kasutab tundmatud sorteerimisalust, lugemine ja kirjutamine on keelatud.
ReportIndexRebuild=Indeksi versioon on uuenenud, korrastan.
ReportIndexUpgrade=Indeksi versioon on uuenenud.
ReportJoinF2=Ühenda: {0} <- {1}
ReportLibraryLoadAddinF1=Lisandmooduli laadimine: {0}
ReportLibraryLoadErrorF1=Teegi laadimine nurjus: {0}
ReportLibraryLoadF1=Teek loetud: {0}
ReportLicenseSerialF1=Serial number: {0}
ReportLogFileF1=Logifail: {0}
ReportLoginTestSucceeded=Ühendus loodud.
ReportMergeF1=Mestimine: {0}
ReportNoteManifoldOnly=Ainult Manifoldi süntaks.
ReportPaintF1=Renderdamine: {0}
ReportPasteF1=Kleepimine: {0}
ReportProjectionF1=Projektsiooniteisendus: {0}
ReportQueryF1=Päring: {0}
ReportRecordsF1=Records: {0}
ReportRecordsSelectedF2=Valitud: {1} {0}-st
ReportRegisterF1=Koordinaatimine: {0}
ReportRenderF1=Save as image: {0}
ReportScriptF1=Skript: {0}
ReportSelectF1=Valik: {0}
ReportServerConnectionAcceptF1=Ühendatud: {0}
ReportServerConnectionCloseF1=Ühendus lõpetatud: {0}
ReportServerConnectionDenyLimitF2=Ühendus {0}st tagasi lükatud, liiga palju ühendusi ({1}).
ReportServerShutdownStart=Sulgen ühendusi
ReportServerStartupFinished=Kuulan ühendusi, lõpetamiseks vajuta Ctrl-C või Ctrl-Break
ReportShutdown=Sulgumine
ReportStartup=Käivitamine
ReportStartupFinished=Käivitatud
ReportTableActionRefreshData=Andmed on muutunud, värskendamiseks vajuta
ReportTableCacheF1=Puhverdamine: {0}
ReportTableRebuild=Tabel pole ajakohane, korrastan.
ReportTestsFailedPassedF2=Nurjus: {0}. Õnnestus: {1}.
ReportTransformF1=Teisendamine: {0}
ReportUiStringsF2={0} / {1} sõne(t)
ReportWorkersF1={0} taustategum(it)
ReportWriteF1=Kirjutamine: {0}

# <template>
TemplateAnyExpression=Avaldis|Tõeväärtus-avaldis
TemplateAnyNull=Null|Nullid / mitte-nullid
TemplateBinaryCopy=Kopeeri|Binaarandmed / baitide arv
TemplateBinaryExpression=Avaldis|Binaaravaldis
TemplateBinarySearch=Otsi|Baitide arv
TemplateBinaryUnique=Unique|Unique / non-unique / duplicate
TemplateBooleanCopy=Kopeeri|Tõeväärtus
TemplateBooleanExpression=Avaldis|Tõeväärtus avaldis
TemplateBooleanLogic=Loogika|Eitus / ja / või / välistav-või
TemplateBooleanSearch=Otsi|Võrdne / mittevõrdne
TemplateDateArithmetic=Arithmetic|Add time / subtract time / time before / time after
TemplateDateCompose=Moodusta|From parts
TemplateDateCopy=Kopeeri|Kuupäev kellaajaga või ilma / aasta / kuu / päev / nädalapäev / ...
TemplateDateExpression=Avaldis|Kuupäeva-avaldis
TemplateDateSearch=Otsi|Kuupäev kellaajaga või ilma / aasta / kuu / päev / nädalapäev / ...
TemplateDateStatistic=Statistic|Minimum / maximum / median / percentile / ...
TemplateDateUnique=Unique|Unique / non-unique / duplicate
TemplateGeomBuffer=Puhver|Sisemine või välimine
TemplateGeomCenter=Tsentroid|Ümberringjoone / sisemine / raskuskese
TemplateGeomClean=Puhasta|Normaliseeri / eemalda või teisenda kõverad / eemalda või lisa Z / ...
TemplateGeomClip=Kärbi|Aladega
TemplateGeomCompose=Moodusta|Point / segment / circle / ...
TemplateGeomConvert=Konverdi|Alaks / jooneks / punktideks
TemplateGeomCopy=Kopeeri|Ruumikuju ise / käänupunkt / tüüp / pindala / pikkus / ...
TemplateGeomEnclose=Ümbritse|Ristkülikuga / ringjoonega / kumera kattega / ...
TemplateGeomExpression=Avaldis|Ruumikuju-avaldis
TemplateGeomInterpolate=Intrerpoleeri|Kriging / raskusjõud / triangulatsioon
TemplateGeomJoin=Ruumiseos|Külgnev / contained / containing / intersecting / touching
TemplateGeomMerge=Mesti|Alad (dissolve) / center / circle / ...
TemplateGeomOverlay=Ülekate|Identity / intersect / union / update
TemplateGeomReshape=Moonda|Nihuta / skaleeri / pööra / pööra ümber / silu / ...
TemplateGeomSearch=Otsi|Tüüp / pindala / pikkus / käänupunktide arv / ...
TemplateGeomSplit=Jaota|Käänupunktideks / objektiga / sirglõikudeks / lahustükkideks / ...
TemplateGeomTopology=Topoloogia|Puhasta (üldista)
TemplateGeomTrace=Trace|Areas bounded by lines
TemplateGeomTriangulate=Triangulatsioon|Loo alad / jooned
TemplateGeomVoronoi=Voronoi|Loo alad / jooned / punktid
TemplateNumberArithmetic=Aritmeetika|Liida / lahuta / korruta / jaga / astenda / ...
TemplateNumberBitLogic=Bitiloogika|Not / and / or / xor
TemplateNumberCopy=Kopeeri|Numeric value
TemplateNumberExpression=Avaldis|Numeric avaldis
TemplateNumberHyperbolic=Hyperbolic|Hyperbolic sine / cosine / tangent / arc sine / ...
TemplateNumberLimit=Limit|Make at least / at most
TemplateNumberRandom=Random|Generate random
TemplateNumberRound=Ümarda|Lähimale / nulli poole / alla / üles
TemplateNumberSearch=Otsi|Väiksem kui / võrdne / suurem kui / vahemikus / ...
TemplateNumberSpecial=Special|Bessel
TemplateNumberStatistic=Statistic|Minimum / maximum / median / percentile / ...
TemplateNumberTrigonometric=Trigonomeetria|Siinus / koosinus / tangens / arkussiinus / ...
TemplateNumberUnique=Unique|Unique / non-unique / duplicate
TemplateNumberX2Compose=Moodusta|New / rearrange values
TemplateNumberX2Copy=Copy|Vector / value
TemplateNumberX2Expression=Avaldis|Vector avaldis
TemplateNumberX2Search=Otsi|Vector / value
TemplateNumberX2Statistic=Statistic|Minimum / maximum / median / percentile / ...
TemplateNumberX2Unique=Unique|Unique / non-unique / duplicate
TemplateNumberX3Compose=Moodusta|New / rearrange values
TemplateNumberX3Copy=Kopeeri|Vector / value
TemplateNumberX3Expression=Avaldis|Vector avaldis
TemplateNumberX3Search=Otsi|Vector / value
TemplateNumberX3Statistic=Statistic|Minimum / maximum / median / percentile / ...
TemplateNumberX3Unique=Unique|Unique / non-unique / duplicate
TemplateNumberX4Compose=Moodusta|New / rearrange values
TemplateNumberX4Copy=Kopeeri|Vector / value
TemplateNumberX4Expression=Avaldis|Vector avaldis
TemplateNumberX4Search=Otsi|Vector / value
TemplateNumberX4Statistic=Statistic|Minimum / maximum / median / percentile / ...
TemplateNumberX4Unique=Unique|Unique / non-unique / duplicate
TemplateTextCase=Case|Lower / upper / title
TemplateTextCompose=Moodusta|GeoJSON / GML / WKT / URL
TemplateTextConcat=Concatenate|At end / start
TemplateTextCopy=Copy|Text / number of characters / JSON value / ...
TemplateTextEncrypt=Krüpteeri|Encrypt / decrypt
TemplateTextExpression=Avaldis|Text avaldis
TemplateTextPad=Pad|Start / end
TemplateTextReduce=Reduce|To start / end / cut / ...
TemplateTextReplace=Replace|Text / regulaaravaldis
TemplateTextReverse=Reverse|Text
TemplateTextSearch=Otsi|Text / pattern / regulaaravaldis / number of characters / ...
TemplateTextStatistic=Statistic|Minimum / maximum / median / percentile / ...
TemplateTextTrim=Trim|Start / end
TemplateTextUnique=Unique|Unique / non-unique / duplicate
TemplateTileArithmetic=Arithmetic|Add / subtract / multiply / divide / power / ...
TemplateTileCompose=Moodusta|Pixels / rearrange channels
TemplateTileContour=Contour|Produce areas / lines
TemplateTileCopy=Kopeeri|Pixels / channel / number of missing pixels / channel average or ...
TemplateTileDistance=Path|Euclidean / cost / cost for slope
TemplateTileExpression=Avaldis|Tile avaldis
TemplateTileFill=Fill|Fill visible / missing
TemplateTileFilter=Filter|Average / median / gaussian blur / sharpen / ...
TemplateTileHyperbolic=Hyperbolic|Hyperbolic sine / cosine / tangent / arc sine / ...
TemplateTileLimit=Limit|Make at least / at most
TemplateTileRound=Round|To nearest / to zero / down / up
TemplateTileSearch=Otsi|Number of missing pixels / channel average or ...
TemplateTileSieve=Sieve|Sieve (merge small areas into their neighbors)
TemplateTileSlope=Slope|Slope / aspect / gaussian or mean or plan or profile curvature
TemplateTileSpecial=Special|Bessel
TemplateTileTrace=Trace|Areas
TemplateTileTrigonometric=Trigonometric|Sine / cosine / tangent / arc sine / ...
TemplateTileViewshed=Viewshed|Produce areas / image
TemplateTileWatershed=Watershed|Produce areas / lines
TemplateTileWatershedPrep=Watershed Prepare|Fill sinks
TemplateUuidCopy=Kopeeri|Uuid väärtus
TemplateUuidExpression=Avaldis|Uuid avaldis
TemplateUuidRandom=Random|Generate random
TemplateUuidSearch=Otsi|Võrdne / mitte võrdne
TemplateUuidUnique=Unique|Unique / non-unique / duplicate

# <parameter>
TemplateParameterAction=Toiming:
TemplateParameterAngle=Nurk:
TemplateParameterAngleMax=Maximum angle:
TemplateParameterAngleMin=Minimum angle:
TemplateParameterAreaMin=Minimum area:
TemplateParameterBarriers=Arvesta tõkkeid
TemplateParameterBase=Base:
TemplateParameterBoundInclude=Include bound
TemplateParameterBoundMax=Mitte üle:
TemplateParameterBoundMin=Vähemalt:
TemplateParameterCase=Case:
TemplateParameterCenter=Center:
TemplateParameterChannel=Kanal:
TemplateParameterChannel0=Kanal 0:
TemplateParameterChannel1=Kanal 1:
TemplateParameterChannel2=Kanal 2:
TemplateParameterChannel3=Kanal 3:
TemplateParameterCheck=Tingimus:
TemplateParameterClip=Kärbi:
TemplateParameterClipInner=Säilita kattuv osa
TemplateParameterClipSelection=Lõika ainult valitud
TemplateParameterCollate=Sorteerimisalus:
TemplateParameterCompose=Moodusta:
TemplateParameterCompute=Ressursid:
TemplateParameterConcat=Lisa alates:
TemplateParameterConvert=Teisenda:
TemplateParameterCostEqual=Võrdsed kaalud
TemplateParameterCostFlat=Flat cost:
TemplateParameterCostSlopeMax=High slope cost:
TemplateParameterCostSlopeMin=Low slope cost:
TemplateParameterCountChars=Pikkus:
TemplateParameterCountCurveCoords=Curve limit:
TemplateParameterCountRecords=Records:
TemplateParameterCountStart=Alusta loendamist:
TemplateParameterDatumCurvature=Use datum curvature
TemplateParameterDay=Day:
TemplateParameterDistance=Kaugus:
TemplateParameterDistanceType=Path type:
TemplateParameterEnclose=Ümbritse:
TemplateParameterEnd=Lõpp:
TemplateParameterExpression=Avaldis:
TemplateParameterExtra=Extra:
TemplateParameterField=Väli:
TemplateParameterFill=Fill:
TemplateParameterFillFlow=Fill flow:
TemplateParameterFillZ=Fill height:
TemplateParameterFilter=Filter:
TemplateParameterFilterCenter=Center:
TemplateParameterFilterDef=Shape:
TemplateParameterFlowMin=Minimum flow:
TemplateParameterGroup=Group:
TemplateParameterHost=Host:
TemplateParameterInterpolate=Interpolation:
TemplateParameterKeepEscaping=Keep areas flowing outside
TemplateParameterKeepOverlaps=Keep overlaps
TemplateParameterLayer=Layer:
TemplateParameterMargin=Margin:
TemplateParameterMeasure=Measure:
TemplateParameterMerge=Merge into:
TemplateParameterModel=Model:
TemplateParameterMonth=Month:
TemplateParameterNeighbors=Neighbors:
TemplateParameterNewDrawing=New drawing:
TemplateParameterNewImage=New image:
TemplateParameterNewTable=New table:
TemplateParameterNoCase=Ignore case
TemplateParameterNoFlatAreas=Remove flat areas (DEST)
TemplateParameterNoTime=Ignore time
TemplateParameterNoWhitespace=Ignore whitespace at start and end
TemplateParameterOperation=Operation:
TemplateParameterOrder=Order:
TemplateParameterOutput=Output:
TemplateParameterOutputType=Output type:
TemplateParameterOverlay=Overlay:
TemplateParameterOverlayFields=Overlay fields:
TemplateParameterOverlaySelection=Overlay selection only
TemplateParameterPad=Pad:
TemplateParameterPadChars=Repeat:
TemplateParameterPart=Use:
TemplateParameterPassword=Password:
TemplateParameterPath=Path:
TemplateParameterPathReverse=Reverse path
TemplateParameterPercent=Percent:
TemplateParameterPick=Occurrence:
TemplateParameterPort=Port:
TemplateParameterQuant=Similarity:
TemplateParameterRadius=Radius:
TemplateParameterReduce=Reduce to:
TemplateParameterRefraction=Refraction:
TemplateParameterRegression=Regression:
TemplateParameterRelative=Relative:
TemplateParameterReplace=Replace:
TemplateParameterReplaceSource=Search for:
TemplateParameterReplaceTarget=Replace with:
TemplateParameterResolution=Resolution:
TemplateParameterResult=Result:
TemplateParameterResultChannel=Result channel:
TemplateParameterResultType=Result type:
TemplateParameterResultTypeChannel=Channel type:
TemplateParameterRound=Round:
TemplateParameterRoundDecs=Round to:
TemplateParameterScheme=Scheme:
TemplateParameterSelection=Transform selection only
TemplateParameterSeparator=Separator:
TemplateParameterSieveMerge=Merge neighbor:
TemplateParameterSlopeMax=High slope:
TemplateParameterSlopeMin=Low slope:
TemplateParameterSource=Start from:
TemplateParameterSourceSelection=Start from selection only
TemplateParameterSplit=Jaota:
TemplateParameterSplitOverlay=Jaotaja:
TemplateParameterSplitOverlaySelection=Split with selection only
TemplateParameterSplitShapes=Jaota üksik-kujunditeks
TemplateParameterStart=Start:
TemplateParameterStartEndFull=Full Range
TemplateParameterStartEndRound=Round start and end to step
TemplateParameterStep=Step:
TemplateParameterSystem=System:
TemplateParameterTolerance=Tolerance:
TemplateParameterTrim=Trim:
TemplateParameterTrimChars=Characters:
TemplateParameterUnit=Unit:
TemplateParameterUser=User:
TemplateParameterValue=Value:
TemplateParameterValue0=Value 0:
TemplateParameterValue1=Value 1:
TemplateParameterValue2=Value 2:
TemplateParameterValue3=Value 3:
TemplateParameterValueChannel=Value channel:
TemplateParameterView=View from:
TemplateParameterViewSelection=View from selection only
TemplateParameterWaterChannel=Water channel:
TemplateParameterWeekStart=Week start:
TemplateParameterWholeNumber=Whole numbers
TemplateParameterX=X:
TemplateParameterX0=X 0:
TemplateParameterX1=X 1:
TemplateParameterX2=X 2:
TemplateParameterXScale=X scale:
TemplateParameterXStep=X step:
TemplateParameterY=Y:
TemplateParameterY0=Y 0:
TemplateParameterY1=Y 1:
TemplateParameterY2=Y 2:
TemplateParameterYScale=Y scale:
TemplateParameterYStep=Y step:
TemplateParameterYear=Year:
TemplateParameterZ=Z:
TemplateParameterZRelative=Relative Z

# <template>|<parameter>|...
TemplateBinaryStringBase64=Moodusta Base64 baidijada|Sõne:
TemplateBinaryStringHex=Moodusta Hex baidijada|Sõne:
TemplateStringBinaryBase64=Parsi Base64 Sõne|Sõne:
TemplateStringBinaryHex=Parsi Hex Sõne|Sõne:
TemplateStringTranslate=Teisenda märgid|Sõne:|Märgid:|Teisenda:
TemplateVectorBgrHcy=Teisenda BGR HCY-ks|Arvx3:
TemplateVectorBgrHsi=Teisenda BGR HSI-ks|Arvx3:
TemplateVectorBgrHsl=Teisenda BGR HSL-ks|Arvx3:
TemplateVectorBgrHsv=Teisenda BGR HSV-ks|Arvx3:
TemplateVectorHcyBgr=Teisenda HCY BGR-ks|Arvx3:
TemplateVectorHsiBgr=Teisenda HSI BGR-ks|Arvx3:
TemplateVectorHslBgr=Teisenda HSL BGR-ks|Arvx3:
TemplateVectorHsvBgr=Teisenda HSV BGR-ks|Arvx3:

# <value>
ValueActionBlank=(toiming puudub)
ValueActionSelect=asenda valik
ValueActionSelectAdd=lisa valikusse
ValueActionSelectIntersect=ühisosa valikuga
ValueActionSelectInvert=mitte-ühisosa valikuga
ValueActionSelectSubtract=eemalda valikust
ValueAlignBottom=alla
ValueAlignCenter=keskele
ValueAlignLeft=vasakule
ValueAlignRight=paremale
ValueAlignTop=üles
ValueBaseNone=tühi
ValueBaseSolid=täis
ValueBinaryIntel=Intel (little-endian)
ValueBinaryMotorola=Motorola (big-endian)
ValueBindBranch=üks haru kohta
ValueBindCoord=one per coordinate
ValueBindGeom=üks kirje kohta
ValueBindRepeat=korda
ValueCaptionAreas=Alad
ValueCaptionLines=Jooned
ValueCaptionPoints=Punktid
ValueCaptionTexts=Märgised
ValueCaseLower=väiketähed
ValueCaseTitle=suuralgustähed
ValueCaseUpper=suurtähed
ValueCenterCircle=ring
ValueCenterInner=inner (area)
ValueCenterWeight=weight (area)
ValueChannel=kanal
ValueChannelNone=(none)
ValueChannelValue=Väärtus
ValueChannelXN=väärtus
ValueCharAuto=(auto)
ValueCharSpace=(tühik)
ValueCharTab=(tab)
ValueCheckBetween=between
ValueCheckBottom=bottom
ValueCheckBottomPercent=bottom percent
ValueCheckContains=contains
ValueCheckContainsRegexp=contains regulaaravaldis
ValueCheckDuplicate=duplicate
ValueCheckEnds=ends with
ValueCheckEqual=equal (=)
ValueCheckGreater=suurem kui (>)
ValueCheckGreaterEqual=suurem võrdne kui (>=)
ValueCheckLess=väiksem kui (<)
ValueCheckLessEqual=väiksem võrdne kui (<=)
ValueCheckMatchesLike=matches pattern (like)
ValueCheckMatchesRegexp=matches regulaaravaldis
ValueCheckMatchesSoundex=sounds like (soundex)
ValueCheckMax=maximum
ValueCheckMedian=median
ValueCheckMin=minimum
ValueCheckNotEqual=mitte-võrdne (<>)
ValueCheckNotNull=not null
ValueCheckNull=null
ValueCheckStarts=algab -ga
ValueCheckTop=top
ValueCheckTopPercent=top percent
ValueCheckUnique=unique
ValueCheckUniqueNot=non-unique
ValueCleanCoordXY=normalize metric
ValueCleanCoordZFill=fill z
ValueCleanCoordZFillMissing=fill missing z
ValueCleanCoordZRemove=eemalda z
ValueCleanCurveConvert=teisenda kõverad murdjooneks
ValueCleanCurveRemove=teisenda kõverad murdjooneks
ValueComposeGeomCircle=ring
ValueComposeGeomPoint=punkt
ValueComposeGeomPointZ=punkt z-ga
ValueComposeGeomRect=ristkülik
ValueComposeGeomSegment=sirglõik
ValueComposeGeomTriangle=kolmnurk
ValueComposeNumberXN=uus
ValueComposeNumberXNRemap=järjesta väärtused ümber
ValueComposeTextGml=gml
ValueComposeTextJsonGeo=geojson
ValueComposeTextUrl=url
ValueComposeTextUrlAppend=url from base and relative
ValueComposeTextWkt=wkt
ValueComposeTile=pikslid
ValueComposeTileRemap=järjesta kanalid ümber
ValueComputeMultiCpuGpu=kõik CPU tuumad, kõik GPU tuumad
ValueComputeMultiCpu=kõik CPU tuumad
ValueComputeSingleCpuGpu=üks CPU tuum, kõik GPU tuumad
ValueComputeSingleCpu=üks CPU tuum
ValueConcatEnd=lõpp
ValueConcatStart=algus
ValueConstraintAny=avaldis
ValueConstraintNotNull=not null
ValueCoord1stLat=1. paralleel
ValueCoord1stLon=1. meridiaan
ValueCoord1stStandardLat=1. standardparalleel
ValueCoord2ndLat=2. paralleel
ValueCoord2ndLon=2. meridiaan
ValueCoord2ndStandardLat=2. standardparalleel
ValueCoordAdjustmentCenterX=Adjustment center X
ValueCoordAdjustmentCenterY=Adjustment center Y
ValueCoordAffineMatrixXX=Afiinne maatriks XX
ValueCoordAffineMatrixXY=Afiinne maatriks XY
ValueCoordAffineMatrixYX=Afiinne maatriks YX
ValueCoordAffineMatrixYY=Afiinne maatriks YY
ValueCoordAffineRotation=Afiinne pööre
ValueCoordAffineScale=Afiinne skaleerimine
ValueCoordAffineShiftX=Afiinne nihe X
ValueCoordAffineShiftY=Afiinne nihe Y
ValueCoordAscendingNodeLon=Ascending node longitude
ValueCoordCenterHeight=Lähtepunkti kõrgus
ValueCoordCenterLat=Lähtepunkti paralleel
ValueCoordCenterLatSec=Center latitude secondary
ValueCoordCenterLineAzimuth=Lähtejoone asimuut
ValueCoordCenterLon=Telgmeridiaan
ValueCoordCenterX=Keskpunkt X
ValueCoordCenterY=Keskpunkt Y
ValueCoordCenterZ=Keskpunkt Z
ValueCoordEccentricity=Ekstsentrilisus
ValueCoordGrid=Grid
ValueCoordGridHeight=Height grid
ValueCoordGridLat=Latitude grid
ValueCoordGridLon=Longitude grid
ValueCoordMajorAxis=Pikem pooltelg
ValueCoordOrbit=Orbiit
ValueCoordOrbitInclination=Orbiidi inklinatsioon
ValueCoordOrbitPath=Orbit path
ValueCoordOrbitsCompleted=Läbitud orbiite
ValueCoordOvalRotation=Oval rotation
ValueCoordOvalShapeM=Oval shape M
ValueCoordOvalShapeN=Oval shape N
ValueCoordPathDefault=(default)
ValueCoordPrimeLon=Algmeridiaan
ValueCoordPseudoStandardLat=Pseudo-standard latitude
ValueCoordRectifiedGrid=Rectified grid
ValueCoordRotationCenterX=Pöörde keskpunkti X
ValueCoordRotationCenterY=Pöörde keskpunkti Y
ValueCoordRotationCenterZ=Pöörde keskpunkti Z
ValueCoordRotationToAscendingNode=Rotation to ascending node
ValueCoordRotationX=Rotation X
ValueCoordRotationY=Rotation Y
ValueCoordRotationZ=Rotation Z
ValueCoordSatelliteRevTime=Satellite revolution time
ValueCoordScaleAdjustment=Scale adjustment
ValueCoordScaleEllipsoid=Ellipsoid scale
ValueCoordScaleLocalX=Skaleeri X
ValueCoordScaleLocalY=Skaleeri Y
ValueCoordScaleLocalZ=Skaleeri Z
ValueCoordScaleX=Mõõtkavategur X
ValueCoordScaleY=Mõõtkavategur Y
ValueCoordShiftLocalX=Nihuta X
ValueCoordShiftLocalY=Nihuta Y
ValueCoordShiftLocalZ=Nihuta Z
ValueCoordShiftX=Idanihe
ValueCoordShiftY=Põhjanihe
ValueCoordSourceScale=Lähte mastaabitegur
ValueCoordSourceScaleLocal=Lähte lokaalne mastaabitegur
ValueCoordSourceX=Source X
ValueCoordSourceY=Source Y
ValueCoordTargetScale=Target mastaabitegur
ValueCoordTargetScaleLocal=Local target mastaabitegur
ValueCoordTargetX=Target X
ValueCoordTargetY=Target Y
ValueCoordTilt=Kalle
ValueCoordTiltAzimuth=Kalde asimuut
ValueCoordTrueScaleLat=True scale latitude
ValueCoordTrueScaleLon=True scale longitude
ValueCoordZoneLonWidth=Width of longitude zone
ValueDashCapFlat=lame
ValueDashCapRound=ümar
ValueDashCapSquare=ruut
ValueDashCapTriangle=kolmnurk
ValueDatabaseCache=(puhver)
ValueDatabaseExport=(eksport)
ValueDatabaseImport=(import)
ValueDatabaseOdbc=(odbc)
ValueDatabasePreview=(eelvaade)
ValueDatabaseRoot=(juurläte)
ValueDatabaseScript=(skript)
ValueDatabaseUnknown=(andmebaas)
ValueDistanceEuclidean=Euclidean
ValueDistancePath=cost
ValueDistancePathSlope=cost for slope
ValueEncloseCircle=ring
ValueEncloseConvexHull=kumer kate
ValueEncloseRect=ristkülik
ValueEncloseRectRot=pööratud ristkülik
ValueEntitiesF1={0} komponent(id)
ValueEntitiesMoreF1=+ veel {0} komponent(i)
ValueEntityResults=Tulemused
ValueFavoriteCoordSystemMetricsKeep=säilita ühikud
ValueFavoriteCoordSystemMetricsOverride=kirjuta ühikud üle
ValueFieldAuto=(sama väli)
ValueFieldAutoGeomZ=(ruumikuju z)
ValueFieldAutoSequence=(järjestikused arvud)
ValueFieldBlank=(välju pole)
ValueFieldBlankSelect=(väli pole valitud)
ValueFieldChannel=Kanal
ValueFieldChannelBgra=(kasuta RGBA kanaleid)
ValueFieldChannelBlankSelect=(kanal pole valitud)
ValueFieldMultiText=(pattern)
ValueFieldNew=(uus väli)
ValueFieldNewTable=(uus tabel)
ValueFieldNone=(mitteükski)
ValueFillBoundAverage=interpoleeri
ValueFillBoundMax=lähim suurem väärtus
ValueFillBoundMin=lähim madalam väärtus
ValueFillGlobalMax=suurim väärtus
ValueFillGlobalMin=vähim väärtus
ValueFillTile=visible pixels
ValueFillTileMissing=missing pixels
ValueFillTileMissingNearest=missing pixels from nearest
ValueFilterAvg=keskmine
ValueFilterBlur=hägusta
ValueFilterBlurDirection=blur direction
ValueFilterBlurGaussian=blur gaussian
ValueFilterCount=loenda
ValueFilterDiversity=diversity
ValueFilterDiversityIndex=diversity index
ValueFilterEdges=servad
ValueFilterEdgesDirection=servad direction
ValueFilterMajor=peamine
ValueFilterMax=suurim
ValueFilterMedian=mediaan
ValueFilterMin=vähim
ValueFilterSharpen=teravusta
ValueFilterStDev=st. hälve
ValueFilterStDevPop=st. hälve pop
ValueFilterSum=summa
ValueFilterVar=variance
ValueFilterVarPop=variance pop
ValueFilterDefCircle=ring
ValueFilterDefCross=rist
ValueFilterDefDiamond=romb
ValueFilterDefSquare=ruut
ValueFitCurve=kääna
ValueFitStraight=sirge
ValueFitStraightFix=rõhtsalt
ValueFitStraightPer=risti
ValueFolderSystemDataDescription=Manifoldi süsteemikomponendid.
ValueFramePrompt=«Ära paanitse!» ☺\nAndmete importimiseks pukseeri failid projektipaanile (valge ala).\nAndmete linkimiseks pukseeri failid projektipaanile ja vabasta need Shift-klahviga.\nKomponendid (tabelid, päringud jne) avanevad topeltklikiga.\nParem-klikk akna või vahelehe päisel võimaldab dokkimist.\nKasulikke käske näed, kui parem-klikid projektipaani komponentidel.\nVajuta F1, et näha vastava akna kohta kiirjuhendit.
ValueGeomArea=ala
ValueGeomLine=joon
ValueGeomPoint=punkt
ValueIndexBlank=(indeksita)
ValueIndexBTree=tavaline indeks (btree)
ValueIndexRTreeGeom=indeks ruumikujule (rtree)
ValueIndexRTreeTile=ruumiindeks tailidele (rtree)
ValueInsertAuto=auto
ValueInsertCircle=ring
ValueInsertDiamond=romb
ValueInsertHexagon=kuusnurk
ValueInsertOctagon=kaheksanurk
ValueInsertPentagon=viisnurk
ValueInsertRectangle=ristkülik
ValueInsertRectangleRound=ristkülik ümar
ValueInsertTriangle=kolmnurk
ValueInterleaveBand=kanali kaupa sektsioneeritud
ValueInterleaveLine=rea kaupa sektsioneeritud
ValueInterleavePixel=piksli kaupa sektsioneeritud
ValueInterpolateGravity=gravity
ValueInterpolateKriging=Kriging
ValueInterpolateKrigingMedianPolish=Kriging with median polish
ValueInterpolateKrigingRegression=Kriging with regression
ValueInterpolateNatural=natural neighbors
ValueInterpolateSpline=thin-plate spline
ValueInterpolateTriangulation=triangulation
ValueInterpolateTriangulationSeg=triangulation with segments
ValueJoinAdjacent=adjacent
ValueJoinContained=contained
ValueJoinContaining=containing
ValueJoinIntersecting=intersecting
ValueJoinTouching=touching
ValueKrigingModelAuto=auto
ValueKrigingModelCircular=tsirkulaarne
ValueKrigingModelExponential=eksponentsiaalne
ValueKrigingModelGaussian=normaaljaotus
ValueKrigingModelLinear=lineaarne
ValueKrigingModelPower=astmef-n
ValueKrigingModelRational=ratsionaalf-n
ValueKrigingModelSpherical=sfääriline
ValueKrigingRegressionAuto=auto
ValueKrigingRegressionLinear=lineaarne
ValueKrigingRegressionQuadratic=kvadraatne
ValueLanguageAuto=(OS keel)
ValueLanguageDefault=(algne)
ValueLayerBackground=Taust
ValueLayerBaseNone=(puudub)
ValueLayerGrid=Grid
ValueLayerLegend=Legend
ValueLayerNorthArrow=North Arrow
ValueLayerScaleBar=Scale Bar
ValueLegendForce=full
ValueLegendForceShort=short
ValueLegendNone=none
ValueLegendVisible=auto full
ValueLegendVisibleShort=auto short
ValueMachCurrent=Paigaldatud
ValueMachNone=Puudub
ValueMeasureGeodetic=geodeetiline
ValueMeasureGeodeticProjected=auto
ValueMergeAreas=alad (dissolve)
ValueMergeCenterCircle=center
ValueMergeCenterInner=tsentriod (ala sees)
ValueMergeCenterWeight=raskuskese (ala)
ValueMergeCircle=circle
ValueMergeConvexHull=convex hull
ValueMergeLines=joon
ValueMergePoints=punktid
ValueMergeRect=kast
ValueMergeRectRot=pööratud kast
ValueMethodIntervalsEqual=võrdsete vahemikega
ValueMethodIntervalsEqualCount=võrdse arvuga
ValueMethodIntervalsExp=eksponentsiaalsete vahemikega
ValueMethodIntervalsNatural=loomulike vahemikega
ValueMethodIntervalsStDev=standardhälbe alusel
ValueMethodValues=üksikväärtused
ValueMetricAreaDiamond=romb
ValueMetricAreaEllipse=ellips
ValueMetricAreaHexagon=kuusnurk
ValueMetricAreaOctagon=kaheksanurk
ValueMetricAreaPentagon=viisnurk
ValueMetricAreaRectangle=ristkülik
ValueMetricAreaRectangleRound=ümarate nurkadega ristkülik
ValueMetricAreaTriangle=kolmnurk
ValueMetricAreaTriangleSkew=viltune kolmnurk
ValueMetricAreaTriangleSkewReverse=triangle skewed top
ValueMetricLineDiag=diagonaal
ValueMetricLineDiagReverse=pööratud diagonaal
ValueMetricLineHorz=horizontal
ValueMetricLineVert=vertical
ValueMetricPointCenter=center
ValueMetricPointDiag=diagonal pair
ValueMetricPointDiagReverse=diagonal pair alt
ValueMetricPointHorz=horizontal pair
ValueMetricPointVert=vertical pair
ValueNewCommentText=<kommentaarid>
ValueNewDatabaseCaption=(Uus projekt)
ValueNewDrawing=(uus vektorjoonis)
ValueNewLocation=(uus asukoht)
ValueNewQueryText=-- $manifold$\n\nSELECT * FROM [mfd_root];
ValueNewTable=(uus tabel)
ValueOdbcCurrent=Installitud
ValueOdbcCurrentMismatch=Installitud sobimatute suvanditega
ValueOdbcForeign=Installitud teises asukohas
ValueOdbcNone=Pole installitud
ValueOperationAbs=absolute value (abs)
ValueOperationAcos=arc cosine (acos)
ValueOperationAcosh=hyperbolic arc cosine (acosh)
ValueOperationAdd=add (+)
ValueOperationAnd=and
ValueOperationAsin=arc sine (asin)
ValueOperationAsinh=hyperbolic arc sine (asinh)
ValueOperationAspect=aspect
ValueOperationAtan=arc tangent (atan)
ValueOperationAtanh=hyperbolic arc tangent (atanh)
ValueOperationBesselJn=Bessel 1st kind (jn)
ValueOperationBesselYn=Bessel 2nd kind (yn)
ValueOperationBoundMax=limit maximum
ValueOperationBoundMin=limit minimum
ValueOperationBoundMinMax=limit both
ValueOperationCos=cosine (cos)
ValueOperationCosh=hyperbolic cosine (cosh)
ValueOperationCurvGaussian=gaussian curvature
ValueOperationCurvMean=mean curvature
ValueOperationCurvPlan=plan curvature
ValueOperationCurvProfile=profile curvature
ValueOperationDateAdd=add time
ValueOperationDateDifference=time after
ValueOperationDateDifferenceRev=time before
ValueOperationDateSubtract=subtract time
ValueOperationDivide=divide (/)
ValueOperationDivideInt=divide integral (div)
ValueOperationDivideMod=divide remainder (mod)
ValueOperationEncrypt=encrypt
ValueOperationEncryptRev=decrypt
ValueOperationErf=error (erf)
ValueOperationErfc=error complement (erfc)
ValueOperationExp=exponent (exp)
ValueOperationExp2=exponent binary (exp2)
ValueOperationExp10=exponent decimal (exp10)
ValueOperationFlipHorz=flip horizontal
ValueOperationFlipVert=flip vertical
ValueOperationGrid=snap to grid
ValueOperationLgamma=gamma logarithm (lgamma)
ValueOperationLog=logarithm (log)
ValueOperationLog2=logarithm binary (log2)
ValueOperationLog10=logarithm decimal (log10)
ValueOperationMultiply=multiply (*)
ValueOperationNot=not
ValueOperationOr=or
ValueOperationPower=power (pow)
ValueOperationPower2=square
ValueOperationPower2Rev=square root (sqrt)
ValueOperationPower3=cube
ValueOperationPower3Rev=cube root (cbrt)
ValueOperationReciprocal=reciprocal
ValueOperationReverse=reverse
ValueOperationRotate=rotate
ValueOperationScale=scale
ValueOperationScaleRev=unscale
ValueOperationShift=shift
ValueOperationSign=sign (sign)
ValueOperationSignInv=sign invert
ValueOperationSin=sine (sin)
ValueOperationSinh=hyperbolic sine (sinh)
ValueOperationSlope=slope
ValueOperationSmooth=smooth
ValueOperationSubtract=subtract (-)
ValueOperationSubtractRev=subtract from (-)
ValueOperationTan=tangent (tan)
ValueOperationTanh=hyperbolic tangent (tanh)
ValueOperationTgamma=gamma (tgamma)
ValueOperationXor=xor
ValueOverlapLayer=layer
ValueOverlapMap=map
ValueOverlayIdentity=identity
ValueOverlayIntersect=intersect
ValueOverlayUnion=union
ValueOverlayUpdate=update
ValuePadEnd=end
ValuePadStart=start
ValuePaperCustom=(kohandatud)
ValuePaperOrientLandscape=horisontaalpaigutus
ValuePaperOrientPortrait=vertikaalpaigutus
ValuePartBinaryBinary=binary data
ValuePartBinaryCountBytes=number of bytes
ValuePartDateDate=date without time
ValuePartDateDateTime=date and time
ValuePartDateDay=päev
ValuePartDateHour=tund
ValuePartDateMillisecond=millisekund
ValuePartDateMinute=minut
ValuePartDateMonth=kuu
ValuePartDateSecond=sekund
ValuePartDateWeek=nädal
ValuePartDateWeekDay=nädalapäev
ValuePartDateYear=aasta
ValuePartDateYearDay=päev aastast
ValuePartGeomArea=pindala
ValuePartGeomBearing=asimuut
ValuePartGeomBranch=haru
ValuePartGeomCountBranches=harude arv
ValuePartGeomCountCoords=käänupunktide arv
ValuePartGeomCountCurves=kõverate arv
ValuePartGeomCoordX=käänupunkti x
ValuePartGeomCoordXY=käänupunkti xy
ValuePartGeomCoordXYZ=käänupunkti xyz
ValuePartGeomCoordY=käänupunkti y
ValuePartGeomCoordZ=käänupunkti z
ValuePartGeomGeom=ruumikuju
ValuePartGeomLength=pikkus
ValuePartGeomRadius=raadius
ValuePartGeomRect=rectangle
ValuePartGeomType=tüüp
ValuePartGeomXMax=x max
ValuePartGeomXMin=x min
ValuePartGeomYMax=y max
ValuePartGeomYMin=y min
ValuePartGeomZMax=z max
ValuePartGeomZMin=z min
ValuePartNumberXN=vector
ValuePartNumberXNValue0=value 0
ValuePartNumberXNValue1=value 1
ValuePartNumberXNValue2=value 2
ValuePartNumberXNValue3=value 3
ValuePartTextCountChars=number of characters
ValuePartTextGmlGeometry=gml geometry
ValuePartTextGmlSystem=gml coordinate system
ValuePartTextJsonGeoGeometry=geojson geometry
ValuePartTextJsonGeoSystem=geojson coordinate system
ValuePartTextJsonValue=json named value
ValuePartTextJsonValueVector=json array value
ValuePartTextText=text
ValuePartTextUrlExtra=url extra
ValuePartTextUrlHost=url host
ValuePartTextUrlPassword=url password
ValuePartTextUrlPath=url path
ValuePartTextUrlPort=url port
ValuePartTextUrlScheme=url scheme
ValuePartTextUrlUser=url user
ValuePartTextWktGeometry=wkt geometry
ValuePartTileChannel=channel
ValuePartTileCountChannels=number of channels
ValuePartTileCountPixels=number of pixels
ValuePartTileCountPixelsMissing=number of missing pixels
ValuePartTileSizeX=x size
ValuePartTileSizeY=y size
ValuePartTileTile=pixels
ValuePartTileValueAvg=channel average
ValuePartTileValueMax=channel maximum
ValuePartTileValueMin=channel minimum
ValuePartTileValueStDev=channel std deviation
ValuePartTileValueStDevPop=channel std deviation pop
ValuePartTileValueSum=channel sum
ValuePartTileValueVar=channel variance
ValuePartTileValueVarPop=channel variance pop
ValuePathDirection=direction
ValuePathLength=distance
ValuePathSource=value
ValuePickAllow=nopi
ValuePickNone=ära nopi
ValueQueryCommand=(käsuaken)
ValueRecords=kirje(t)
ValueRecordsAll=(kõik)
ValueRecordsAuto=(auto)
ValueReduceEnd=end
ValueReduceMid=cut
ValueReduceMidToEnd=cut to end
ValueReduceRegexpPick=esinemiskord
ValueReduceStart=start
ValueRegisterCoord=Ankurpunkt
ValueRegisterSourceNone=(aktiivne aken)
ValueRenderForwardAverage=forward, average
ValueRenderForwardNearest=forward, nearest
ValueRenderInverseBicubic=inverse, bicubic
ValueRenderInverseBilinear=inverse, bilinear
ValueRenderInverseNearest=inverse, nearest
ValueReplaceRegexp=regulaaravaldis
ValueReplaceRegexpPick=esinemiskord
ValueReplaceText=tekst
ValueReplaceTextPick=esinemiskord
ValueRoundCeil=üles (ceil)
ValueRoundFloor=alla (floor)
ValueRoundNone=ära ümarda
ValueRoundRound=lähim (round)
ValueRoundTrunc=nulli poole (trunc)
ValueRoundTargetBase=1
ValueRoundTargetM1=10
ValueRoundTargetM2=100
ValueRoundTargetM3=1000
ValueRoundTargetM4=10000
ValueRoundTargetM5=100000
ValueRoundTargetM6=1000000
ValueRoundTargetP1=0,1
ValueRoundTargetP2=0,01
ValueRoundTargetP3=0,001
ValueRoundTargetP4=0,0001
ValueRoundTargetP5=0,00001
ValueRoundTargetP6=0,000001
ValueScaleAny=kõik
ValueScaleNone=mitteüks
ValueScaleTypeAbsolute=absolute scale
ValueScaleTypeSizePixel=pixel size
ValueScaleTypeSizeView=view size
ValueSchemaItemsMoreF1=+ veel {0} element(i)
ValueServer=Peamine
ValueServerGeocode=Geokodeerija
ValueServerGeocodeReverse=Pöörd-geokodeerija
ValueServerGeocodeSearch=Otsisõne
ValueServerGeocodeSearchCircle=Otsi raadiusest
ValueServerGeocodeSearchRect=Otsi kastist
ValueServiceStartAuto=auto
ValueServiceStartManual=käsitsi
ValueServiceStartNone=blockeeritud
ValueServiceStatePaused=pausil
ValueServiceStateRunning=töötab
ValueServiceStateStarting=käivitub
ValueServiceStateStopped=peatunud
ValueServiceStateStopping=peatub
ValueSideNone=(puudub)
ValueSieveMergeArea=biggest area
ValueSieveMergeBoundary=biggest common boundary
ValueSnapAllow=snäpi
ValueSnapNone=ära snäpi
ValueSplitBranches=harudeks
ValueSplitConvex=kumerateks osadeks
ValueSplitCoords=käänupunktideks
ValueSplitCoordsSequence=käänupunktid iga _ tagant
ValueSplitParts=objektiga
ValueSplitPartsSequence=jooned iga _ tagant
ValueSplitSegments=sirglõigukudeks
ValueSplitShapes=lahustükkideks
ValueSplitShapesEsri=lahustükkideks (ESRI mitte-OGC)
ValueSplitTriangles=kolmnurkadeks
ValueStartEnd=kuni
ValueStartStart=alates
ValueStyleDefault=(vaikimisi)
ValueStyleGroupBasic=Lihtne
ValueStyleGroupCurrent=Praegune
ValueStyleGroupGlyphs=Glüüfid
ValueStyleGroupGlyphsBrands=Brändid
ValueStyleGroupImages=Pildid
ValueStyleGroupStandard=Standard
ValueStyleGroupWeb=Veeb
ValueSystemMemoryAuto=(auto)
ValueTechnologyDatabase=Andmebaas
ValueTechnologyFile=Fail
ValueTechnologyFolder=Kaust
ValueTechnologyWeb=Veebiserver
ValueTitleReadOnly=Kirjutuskaitstud
ValueTopologyClean=puhasta (üldista)
ValueTransferAvg=keskmine
ValueTransferCopy=koopia
ValueTransferCopyConvert=teisenda
ValueTransferCount=loenda
ValueTransferDiversity=diversity
ValueTransferDiversityIndex=liigierisus
ValueTransferGeomCenter=tsentroid
ValueTransferGeomConvexHull=kumer kate
ValueTransferGeomMergeAreas=mesti alad
ValueTransferGeomMergeLines=mesti jooned
ValueTransferGeomMergePoints=mesti punktid
ValueTransferGeomUnionAreas=alade ühend
ValueTransferGeomUnionRects=kastide ühend
ValueTransferJoinAnd=loogiline ja
ValueTransferJoinBitAnd=bitikaupa ja
ValueTransferJoinBitOr=bitikaupa või
ValueTransferJoinBitXor=bitikaupa xor
ValueTransferJoinOr=loogiline või
ValueTransferJoinXor=loogiline xor
ValueTransferMajor=peamine
ValueTransferMax=maksimaalne
ValueTransferMedian=mediaan
ValueTransferMin=minimaalne
ValueTransferNone=(puudub)
ValueTransferSplit=jaota
ValueTransferSplitWeighted=jaota proportsionaalselt
ValueTransferStDev=st.hälve
ValueTransferStDevPop=st.hälve pop
ValueTransferStringJoinTokens=ühenda tekst
ValueTransferSum=summa
ValueTransferTileGeomAvg=keskmine
ValueTransferTileGeomCount=arv
ValueTransferTileGeomDiversity=diversity
ValueTransferTileGeomDiversityIndex=liigierisus
ValueTransferTileGeomMajor=peamine
ValueTransferTileGeomMax=maksimum
ValueTransferTileGeomMedian=mediaan
ValueTransferTileGeomMin=miinimum
ValueTransferTileGeomOverlayCount=loenda
ValueTransferTileGeomOverlayMax=maksimum
ValueTransferTileGeomOverlayMin=miinimum
ValueTransferTileGeomOverlaySum=summa
ValueTransferTileGeomSample=näidis
ValueTransferTileGeomStDev=st.hälve
ValueTransferTileGeomStDevPop=st.hälve pop
ValueTransferTileGeomSum=summa
ValueTransferTileGeomVar=dispersioon
ValueTransferTileGeomVarPop=dispersioon pop
ValueTransferVar=dispersioon
ValueTransferVarPop=dispersioon pop
ValueTransform=Teisenda
ValueTrimCharsUser=muud
ValueTrimCharsWhitespace=tühikud
ValueTrimCharsWhitespaceUser=tühikud ja muud
ValueTrimEnd=lõpust
ValueTrimNone=none
ValueTrimStart=algusest
ValueTrimStartEnd=algusest ja lõpust
ValueUnitAuto=(auto)
ValueUnitNative=Projektsiooniühik
ValueViewRenderCentered=centered view at current scale
ValueViewRenderCurrent=current view
ValueViewRenderCustom=custom view
ValueViewRenderFull=full view
ValueViewshedAreaAll=nähtav igast punktist
ValueViewshedAreaAny=nähtav mõnest punktist
ValueViewshedTilesCount=nähtavate punktide arv
ValueViewshedTilesLevelAll=kõrgus millelt näeb kõiki punkte
ValueViewshedTilesLevelAny=kõrgus millelt näeb mõnda punkte
ValueWarpNumeric1=lineaarteisendus, afiinne
ValueWarpNumeric1xCross=1,5. järku, afiinne + ristkorrutis
ValueWarpNumeric1xProjective=lineaarteisendus, projektiivne
ValueWarpNumeric1xShiftScale=lineaarteisendus, nihe + suurendus
ValueWarpNumeric1xShiftScaleRotate=lineaarteisendus, nihe + suurendus + pööre
ValueWarpNumeric2=2. järku teisendus
ValueWarpNumeric3=3. järku teisendus
ValueWarpThinPlateSpline=thin-plate spline
ValueWarpTriangulation=triangulatsioon
ValueWatershedAreas=alad
ValueWatershedAreasSinks=lohud
ValueWatershedAreasUpstream=alad ülesvoolu
ValueWatershedLines=jooned
ValueWatershedLinesDownstream=jooned allavoolu
ValueWatershedLinesUpstream=jooned ülesvoolu
ValueWeekDayFriday=Reede
ValueWeekDayMonday=Esmaspäev
ValueWeekDaySaturday=Laupäev
ValueWeekDaySunday=Pühapäev
ValueWeekDayThursday=Neljapäev
ValueWeekDayTuesday=Teisipäev
ValueWeekDayWednesday=Kolmapäev

# <name>
WindowCommand=Käsuaken
WindowCommandLog=Käsulogi
WindowCommandQueryBuilder=Päringuabiline
WindowCommandResults=Tulemused
WindowLog=Logifail
